instant,dteday,season,yr,mnth,holiday,weekday,workingday,weathersit,temp,atemp,hum,windspeed,casual,registered,cnt,season_label,weather_label,Recency,Frequency,Monetary,R_Score,F_Score,M_Score,RFM_Segment
1,2011-01-01,1,0,1,0,6,0,2,0.344167,0.363625,0.805833,0.160446,331,654,985,Spring,Mist + Cloudy,730,654,985,1,1,1,111
2,2011-01-02,1,0,1,0,0,0,2,0.363478,0.353739,0.696087,0.248539,131,670,801,Spring,Mist + Cloudy,729,670,801,1,1,1,111
3,2011-01-03,1,0,1,0,1,1,1,0.196364,0.189405,0.437273,0.248309,120,1229,1349,Spring,Clear,728,1229,1349,1,1,1,111
4,2011-01-04,1,0,1,0,2,1,1,0.2,0.212122,0.590435,0.160296,108,1454,1562,Spring,Clear,727,1454,1562,1,1,1,111
5,2011-01-05,1,0,1,0,3,1,1,0.226957,0.22927,0.436957,0.1869,82,1518,1600,Spring,Clear,726,1518,1600,1,1,1,111
6,2011-01-06,1,0,1,0,4,1,1,0.204348,0.233209,0.518261,0.0895652,88,1518,1606,Spring,Clear,725,1518,1606,1,1,1,111
7,2011-01-07,1,0,1,0,5,1,2,0.196522,0.208839,0.498696,0.168726,148,1362,1510,Spring,Mist + Cloudy,724,1362,1510,1,1,1,111
8,2011-01-08,1,0,1,0,6,0,2,0.165,0.162254,0.535833,0.266804,68,891,959,Spring,Mist + Cloudy,723,891,959,1,1,1,111
9,2011-01-09,1,0,1,0,0,0,1,0.138333,0.116175,0.434167,0.36195,54,768,822,Spring,Clear,722,768,822,1,1,1,111
10,2011-01-10,1,0,1,0,1,1,1,0.150833,0.150888,0.482917,0.223267,41,1280,1321,Spring,Clear,721,1280,1321,1,1,1,111
11,2011-01-11,1,0,1,0,2,1,2,0.169091,0.191464,0.686364,0.122132,43,1220,1263,Spring,Mist + Cloudy,720,1220,1263,1,1,1,111
12,2011-01-12,1,0,1,0,3,1,1,0.172727,0.160473,0.599545,0.304627,25,1137,1162,Spring,Clear,719,1137,1162,1,1,1,111
13,2011-01-13,1,0,1,0,4,1,1,0.165,0.150883,0.470417,0.301,38,1368,1406,Spring,Clear,718,1368,1406,1,1,1,111
14,2011-01-14,1,0,1,0,5,1,1,0.16087,0.188413,0.537826,0.126548,54,1367,1421,Spring,Clear,717,1367,1421,1,1,1,111
15,2011-01-15,1,0,1,0,6,0,2,0.233333,0.248112,0.49875,0.157963,222,1026,1248,Spring,Mist + Cloudy,716,1026,1248,1,1,1,111
16,2011-01-16,1,0,1,0,0,0,1,0.231667,0.234217,0.48375,0.188433,251,953,1204,Spring,Clear,715,953,1204,1,1,1,111
17,2011-01-17,1,0,1,1,1,0,2,0.175833,0.176771,0.5375,0.194017,117,883,1000,Spring,Mist + Cloudy,714,883,1000,1,1,1,111
18,2011-01-18,1,0,1,0,2,1,2,0.216667,0.232333,0.861667,0.146775,9,674,683,Spring,Mist + Cloudy,713,674,683,1,1,1,111
19,2011-01-19,1,0,1,0,3,1,2,0.292174,0.298422,0.741739,0.208317,78,1572,1650,Spring,Mist + Cloudy,712,1572,1650,1,1,1,111
20,2011-01-20,1,0,1,0,4,1,2,0.261667,0.25505,0.538333,0.195904,83,1844,1927,Spring,Mist + Cloudy,711,1844,1927,1,1,1,111
21,2011-01-21,1,0,1,0,5,1,1,0.1775,0.157833,0.457083,0.353242,75,1468,1543,Spring,Clear,710,1468,1543,1,1,1,111
22,2011-01-22,1,0,1,0,6,0,1,0.0591304,0.0790696,0.4,0.17197,93,888,981,Spring,Clear,709,888,981,1,1,1,111
23,2011-01-23,1,0,1,0,0,0,1,0.0965217,0.0988391,0.436522,0.2466,150,836,986,Spring,Clear,708,836,986,1,1,1,111
24,2011-01-24,1,0,1,0,1,1,1,0.0973913,0.11793,0.491739,0.15833,86,1330,1416,Spring,Clear,707,1330,1416,1,1,1,111
25,2011-01-25,1,0,1,0,2,1,2,0.223478,0.234526,0.616957,0.129796,186,1799,1985,Spring,Mist + Cloudy,706,1799,1985,1,1,1,111
26,2011-01-26,1,0,1,0,3,1,3,0.2175,0.2036,0.8625,0.29385,34,472,506,Spring,Light Snow/Rain,705,472,506,1,1,1,111
27,2011-01-27,1,0,1,0,4,1,1,0.195,0.2197,0.6875,0.113837,15,416,431,Spring,Clear,704,416,431,1,1,1,111
28,2011-01-28,1,0,1,0,5,1,2,0.203478,0.223317,0.793043,0.1233,38,1129,1167,Spring,Mist + Cloudy,703,1129,1167,1,1,1,111
29,2011-01-29,1,0,1,0,6,0,1,0.196522,0.212126,0.651739,0.145365,123,975,1098,Spring,Clear,702,975,1098,1,1,1,111
30,2011-01-30,1,0,1,0,0,0,1,0.216522,0.250322,0.722174,0.0739826,140,956,1096,Spring,Clear,701,956,1096,1,1,1,111
31,2011-01-31,1,0,1,0,1,1,2,0.180833,0.18625,0.60375,0.187192,42,1459,1501,Spring,Mist + Cloudy,700,1459,1501,1,1,1,111
32,2011-02-01,1,0,2,0,2,1,2,0.192174,0.23453,0.829565,0.053213,47,1313,1360,Spring,Mist + Cloudy,699,1313,1360,1,1,1,111
33,2011-02-02,1,0,2,0,3,1,2,0.26,0.254417,0.775417,0.264308,72,1454,1526,Spring,Mist + Cloudy,698,1454,1526,1,1,1,111
34,2011-02-03,1,0,2,0,4,1,1,0.186957,0.177878,0.437826,0.277752,61,1489,1550,Spring,Clear,697,1489,1550,1,1,1,111
35,2011-02-04,1,0,2,0,5,1,2,0.211304,0.228587,0.585217,0.127839,88,1620,1708,Spring,Mist + Cloudy,696,1620,1708,1,1,1,111
36,2011-02-05,1,0,2,0,6,0,2,0.233333,0.243058,0.929167,0.161079,100,905,1005,Spring,Mist + Cloudy,695,905,1005,1,1,1,111
37,2011-02-06,1,0,2,0,0,0,1,0.285833,0.291671,0.568333,0.1418,354,1269,1623,Spring,Clear,694,1269,1623,1,1,1,111
38,2011-02-07,1,0,2,0,1,1,1,0.271667,0.303658,0.738333,0.0454083,120,1592,1712,Spring,Clear,693,1592,1712,1,1,1,111
39,2011-02-08,1,0,2,0,2,1,1,0.220833,0.198246,0.537917,0.36195,64,1466,1530,Spring,Clear,692,1466,1530,1,1,1,111
40,2011-02-09,1,0,2,0,3,1,2,0.134783,0.144283,0.494783,0.188839,53,1552,1605,Spring,Mist + Cloudy,691,1552,1605,1,1,1,111
41,2011-02-10,1,0,2,0,4,1,1,0.144348,0.149548,0.437391,0.221935,47,1491,1538,Spring,Clear,690,1491,1538,1,1,1,111
42,2011-02-11,1,0,2,0,5,1,1,0.189091,0.213509,0.506364,0.10855,149,1597,1746,Spring,Clear,689,1597,1746,1,1,1,111
43,2011-02-12,1,0,2,0,6,0,1,0.2225,0.232954,0.544167,0.203367,288,1184,1472,Spring,Clear,688,1184,1472,1,1,1,111
44,2011-02-13,1,0,2,0,0,0,1,0.316522,0.324113,0.457391,0.260883,397,1192,1589,Spring,Clear,687,1192,1589,1,1,1,111
45,2011-02-14,1,0,2,0,1,1,1,0.415,0.39835,0.375833,0.417908,208,1705,1913,Spring,Clear,686,1705,1913,1,1,1,111
46,2011-02-15,1,0,2,0,2,1,1,0.266087,0.254274,0.314348,0.291374,140,1675,1815,Spring,Clear,685,1675,1815,1,1,1,111
47,2011-02-16,1,0,2,0,3,1,1,0.318261,0.3162,0.423478,0.251791,218,1897,2115,Spring,Clear,684,1897,2115,1,1,1,111
48,2011-02-17,1,0,2,0,4,1,1,0.435833,0.428658,0.505,0.230104,259,2216,2475,Spring,Clear,683,2216,2475,1,1,1,111
49,2011-02-18,1,0,2,0,5,1,1,0.521667,0.511983,0.516667,0.264925,579,2348,2927,Spring,Clear,682,2348,2927,1,1,1,111
50,2011-02-19,1,0,2,0,6,0,1,0.399167,0.391404,0.187917,0.507463,532,1103,1635,Spring,Clear,681,1103,1635,1,1,1,111
51,2011-02-20,1,0,2,0,0,0,1,0.285217,0.27733,0.407826,0.223235,639,1173,1812,Spring,Clear,680,1173,1812,1,1,1,111
52,2011-02-21,1,0,2,1,1,0,2,0.303333,0.284075,0.605,0.307846,195,912,1107,Spring,Mist + Cloudy,679,912,1107,1,1,1,111
53,2011-02-22,1,0,2,0,2,1,1,0.182222,0.186033,0.577778,0.195683,74,1376,1450,Spring,Clear,678,1376,1450,1,1,1,111
54,2011-02-23,1,0,2,0,3,1,1,0.221739,0.245717,0.423043,0.094113,139,1778,1917,Spring,Clear,677,1778,1917,1,1,1,111
55,2011-02-24,1,0,2,0,4,1,2,0.295652,0.289191,0.697391,0.250496,100,1707,1807,Spring,Mist + Cloudy,676,1707,1807,1,1,1,111
56,2011-02-25,1,0,2,0,5,1,2,0.364348,0.350461,0.712174,0.346539,120,1341,1461,Spring,Mist + Cloudy,675,1341,1461,1,1,1,111
57,2011-02-26,1,0,2,0,6,0,1,0.2825,0.282192,0.537917,0.186571,424,1545,1969,Spring,Clear,674,1545,1969,1,1,1,111
58,2011-02-27,1,0,2,0,0,0,1,0.343478,0.351109,0.68,0.125248,694,1708,2402,Spring,Clear,673,1708,2402,1,1,1,111
59,2011-02-28,1,0,2,0,1,1,2,0.407273,0.400118,0.876364,0.289686,81,1365,1446,Spring,Mist + Cloudy,672,1365,1446,1,1,1,111
60,2011-03-01,1,0,3,0,2,1,1,0.266667,0.263879,0.535,0.216425,137,1714,1851,Spring,Clear,671,1714,1851,1,1,1,111
61,2011-03-02,1,0,3,0,3,1,1,0.335,0.320071,0.449583,0.307833,231,1903,2134,Spring,Clear,670,1903,2134,1,1,1,111
62,2011-03-03,1,0,3,0,4,1,1,0.198333,0.200133,0.318333,0.225754,123,1562,1685,Spring,Clear,669,1562,1685,1,1,1,111
63,2011-03-04,1,0,3,0,5,1,2,0.261667,0.255679,0.610417,0.203346,214,1730,1944,Spring,Mist + Cloudy,668,1730,1944,1,1,1,111
64,2011-03-05,1,0,3,0,6,0,2,0.384167,0.378779,0.789167,0.251871,640,1437,2077,Spring,Mist + Cloudy,667,1437,2077,1,1,1,111
65,2011-03-06,1,0,3,0,0,0,2,0.376522,0.366252,0.948261,0.343287,114,491,605,Spring,Mist + Cloudy,666,491,605,1,1,1,111
66,2011-03-07,1,0,3,0,1,1,1,0.261739,0.238461,0.551304,0.341352,244,1628,1872,Spring,Clear,665,1628,1872,1,1,1,111
67,2011-03-08,1,0,3,0,2,1,1,0.2925,0.3024,0.420833,0.12065,316,1817,2133,Spring,Clear,664,1817,2133,1,1,1,111
68,2011-03-09,1,0,3,0,3,1,2,0.295833,0.286608,0.775417,0.22015,191,1700,1891,Spring,Mist + Cloudy,663,1700,1891,1,1,1,111
69,2011-03-10,1,0,3,0,4,1,3,0.389091,0.385668,0.0,0.261877,46,577,623,Spring,Light Snow/Rain,662,577,623,1,1,1,111
70,2011-03-11,1,0,3,0,5,1,2,0.316522,0.305,0.649565,0.23297,247,1730,1977,Spring,Mist + Cloudy,661,1730,1977,1,1,1,111
71,2011-03-12,1,0,3,0,6,0,1,0.329167,0.32575,0.594583,0.220775,724,1408,2132,Spring,Clear,660,1408,2132,1,1,1,111
72,2011-03-13,1,0,3,0,0,0,1,0.384348,0.380091,0.527391,0.270604,982,1435,2417,Spring,Clear,659,1435,2417,1,1,1,111
73,2011-03-14,1,0,3,0,1,1,1,0.325217,0.332,0.496957,0.136926,359,1687,2046,Spring,Clear,658,1687,2046,1,1,1,111
74,2011-03-15,1,0,3,0,2,1,2,0.317391,0.318178,0.655652,0.184309,289,1767,2056,Spring,Mist + Cloudy,657,1767,2056,1,1,1,111
75,2011-03-16,1,0,3,0,3,1,2,0.365217,0.36693,0.776522,0.203117,321,1871,2192,Spring,Mist + Cloudy,656,1871,2192,1,1,1,111
76,2011-03-17,1,0,3,0,4,1,1,0.415,0.410333,0.602917,0.209579,424,2320,2744,Spring,Clear,655,2320,2744,1,1,1,111
77,2011-03-18,1,0,3,0,5,1,1,0.54,0.527009,0.525217,0.231017,884,2355,3239,Spring,Clear,654,2355,3239,1,1,2,112
78,2011-03-19,1,0,3,0,6,0,1,0.4725,0.466525,0.379167,0.368167,1424,1693,3117,Spring,Clear,653,1693,3117,1,1,1,111
79,2011-03-20,1,0,3,0,0,0,1,0.3325,0.32575,0.47375,0.207721,1047,1424,2471,Spring,Clear,652,1424,2471,1,1,1,111
80,2011-03-21,2,0,3,0,1,1,2,0.430435,0.409735,0.737391,0.288783,401,1676,2077,Summer,Mist + Cloudy,651,1676,2077,1,1,1,111
81,2011-03-22,2,0,3,0,2,1,1,0.441667,0.440642,0.624583,0.22575,460,2243,2703,Summer,Clear,650,2243,2703,1,1,1,111
82,2011-03-23,2,0,3,0,3,1,2,0.346957,0.337939,0.839565,0.234261,203,1918,2121,Summer,Mist + Cloudy,649,1918,2121,1,1,1,111
83,2011-03-24,2,0,3,0,4,1,2,0.285,0.270833,0.805833,0.243787,166,1699,1865,Summer,Mist + Cloudy,648,1699,1865,1,1,1,111
84,2011-03-25,2,0,3,0,5,1,1,0.264167,0.256312,0.495,0.230725,300,1910,2210,Summer,Clear,647,1910,2210,1,1,1,111
85,2011-03-26,2,0,3,0,6,0,1,0.265833,0.257571,0.394167,0.209571,981,1515,2496,Summer,Clear,646,1515,2496,1,1,1,111
86,2011-03-27,2,0,3,0,0,0,2,0.253043,0.250339,0.493913,0.1843,472,1221,1693,Summer,Mist + Cloudy,645,1221,1693,1,1,1,111
87,2011-03-28,2,0,3,0,1,1,1,0.264348,0.257574,0.302174,0.212204,222,1806,2028,Summer,Clear,644,1806,2028,1,1,1,111
88,2011-03-29,2,0,3,0,2,1,1,0.3025,0.292908,0.314167,0.226996,317,2108,2425,Summer,Clear,643,2108,2425,1,1,1,111
89,2011-03-30,2,0,3,0,3,1,2,0.3,0.29735,0.646667,0.172888,168,1368,1536,Summer,Mist + Cloudy,642,1368,1536,1,1,1,111
90,2011-03-31,2,0,3,0,4,1,3,0.268333,0.257575,0.918333,0.217646,179,1506,1685,Summer,Light Snow/Rain,641,1506,1685,1,1,1,111
91,2011-04-01,2,0,4,0,5,1,2,0.3,0.283454,0.68625,0.258708,307,1920,2227,Summer,Mist + Cloudy,640,1920,2227,1,1,1,111
92,2011-04-02,2,0,4,0,6,0,2,0.315,0.315637,0.65375,0.197146,898,1354,2252,Summer,Mist + Cloudy,639,1354,2252,1,1,1,111
93,2011-04-03,2,0,4,0,0,0,1,0.378333,0.378767,0.48,0.182213,1651,1598,3249,Summer,Clear,638,1598,3249,1,1,2,112
94,2011-04-04,2,0,4,0,1,1,1,0.573333,0.542929,0.42625,0.385571,734,2381,3115,Summer,Clear,637,2381,3115,1,1,1,111
95,2011-04-05,2,0,4,0,2,1,2,0.414167,0.39835,0.642083,0.388067,167,1628,1795,Summer,Mist + Cloudy,636,1628,1795,1,1,1,111
96,2011-04-06,2,0,4,0,3,1,1,0.390833,0.387608,0.470833,0.263063,413,2395,2808,Summer,Clear,635,2395,2808,1,1,1,111
97,2011-04-07,2,0,4,0,4,1,1,0.4375,0.433696,0.602917,0.162312,571,2570,3141,Summer,Clear,634,2570,3141,1,2,1,121
98,2011-04-08,2,0,4,0,5,1,2,0.335833,0.324479,0.83625,0.226992,172,1299,1471,Summer,Mist + Cloudy,633,1299,1471,1,1,1,111
99,2011-04-09,2,0,4,0,6,0,2,0.3425,0.341529,0.8775,0.133083,879,1576,2455,Summer,Mist + Cloudy,632,1576,2455,1,1,1,111
100,2011-04-10,2,0,4,0,0,0,2,0.426667,0.426737,0.8575,0.146767,1188,1707,2895,Summer,Mist + Cloudy,631,1707,2895,1,1,1,111
101,2011-04-11,2,0,4,0,1,1,2,0.595652,0.565217,0.716956,0.324474,855,2493,3348,Summer,Mist + Cloudy,630,2493,3348,1,1,2,112
102,2011-04-12,2,0,4,0,2,1,2,0.5025,0.493054,0.739167,0.274879,257,1777,2034,Summer,Mist + Cloudy,629,1777,2034,1,1,1,111
103,2011-04-13,2,0,4,0,3,1,2,0.4125,0.417283,0.819167,0.250617,209,1953,2162,Summer,Mist + Cloudy,628,1953,2162,1,1,1,111
104,2011-04-14,2,0,4,0,4,1,1,0.4675,0.462742,0.540417,0.1107,529,2738,3267,Summer,Clear,627,2738,3267,1,2,2,122
105,2011-04-15,2,0,4,1,5,0,1,0.446667,0.441913,0.67125,0.226375,642,2484,3126,Summer,Clear,626,2484,3126,1,1,1,111
106,2011-04-16,2,0,4,0,6,0,3,0.430833,0.425492,0.888333,0.340808,121,674,795,Summer,Light Snow/Rain,625,674,795,1,1,1,111
107,2011-04-17,2,0,4,0,0,0,1,0.456667,0.445696,0.479583,0.303496,1558,2186,3744,Summer,Clear,624,2186,3744,1,1,2,112
108,2011-04-18,2,0,4,0,1,1,1,0.5125,0.503146,0.5425,0.163567,669,2760,3429,Summer,Clear,623,2760,3429,1,2,2,122
109,2011-04-19,2,0,4,0,2,1,2,0.505833,0.489258,0.665833,0.157971,409,2795,3204,Summer,Mist + Cloudy,622,2795,3204,1,2,2,122
110,2011-04-20,2,0,4,0,3,1,1,0.595,0.564392,0.614167,0.241925,613,3331,3944,Summer,Clear,621,3331,3944,1,2,2,122
111,2011-04-21,2,0,4,0,4,1,1,0.459167,0.453892,0.407083,0.325258,745,3444,4189,Summer,Clear,620,3444,4189,1,2,2,122
112,2011-04-22,2,0,4,0,5,1,2,0.336667,0.321954,0.729583,0.219521,177,1506,1683,Summer,Mist + Cloudy,619,1506,1683,1,1,1,111
113,2011-04-23,2,0,4,0,6,0,2,0.46,0.450121,0.887917,0.230725,1462,2574,4036,Summer,Mist + Cloudy,618,2574,4036,1,2,2,122
114,2011-04-24,2,0,4,0,0,0,2,0.581667,0.551763,0.810833,0.192175,1710,2481,4191,Summer,Mist + Cloudy,617,2481,4191,1,1,2,112
115,2011-04-25,2,0,4,0,1,1,1,0.606667,0.5745,0.776667,0.185333,773,3300,4073,Summer,Clear,616,3300,4073,1,2,2,122
116,2011-04-26,2,0,4,0,2,1,1,0.631667,0.594083,0.729167,0.3265,678,3722,4400,Summer,Clear,615,3722,4400,1,3,2,132
117,2011-04-27,2,0,4,0,3,1,2,0.62,0.575142,0.835417,0.3122,547,3325,3872,Summer,Mist + Cloudy,614,3325,3872,1,2,2,122
118,2011-04-28,2,0,4,0,4,1,2,0.6175,0.578929,0.700833,0.320908,569,3489,4058,Summer,Mist + Cloudy,613,3489,4058,1,2,2,122
119,2011-04-29,2,0,4,0,5,1,1,0.51,0.497463,0.457083,0.240063,878,3717,4595,Summer,Clear,612,3717,4595,1,3,3,133
120,2011-04-30,2,0,4,0,6,0,1,0.4725,0.464021,0.503333,0.235075,1965,3347,5312,Summer,Clear,611,3347,5312,1,2,3,123
121,2011-05-01,2,0,5,0,0,0,2,0.451667,0.448204,0.762083,0.106354,1138,2213,3351,Summer,Mist + Cloudy,610,2213,3351,1,1,2,112
122,2011-05-02,2,0,5,0,1,1,2,0.549167,0.532833,0.73,0.183454,847,3554,4401,Summer,Mist + Cloudy,609,3554,4401,1,2,2,122
123,2011-05-03,2,0,5,0,2,1,2,0.616667,0.582079,0.697083,0.342667,603,3848,4451,Summer,Mist + Cloudy,608,3848,4451,1,3,2,132
124,2011-05-04,2,0,5,0,3,1,2,0.414167,0.40465,0.737083,0.328996,255,2378,2633,Summer,Mist + Cloudy,607,2378,2633,1,1,1,111
125,2011-05-05,2,0,5,0,4,1,1,0.459167,0.441917,0.444167,0.295392,614,3819,4433,Summer,Clear,606,3819,4433,1,3,2,132
126,2011-05-06,2,0,5,0,5,1,1,0.479167,0.474117,0.59,0.228246,894,3714,4608,Summer,Clear,605,3714,4608,1,3,3,133
127,2011-05-07,2,0,5,0,6,0,1,0.52,0.512621,0.54125,0.16045,1612,3102,4714,Summer,Clear,604,3102,4714,1,2,3,123
128,2011-05-08,2,0,5,0,0,0,1,0.528333,0.518933,0.631667,0.0746375,1401,2932,4333,Summer,Clear,603,2932,4333,1,2,2,122
129,2011-05-09,2,0,5,0,1,1,1,0.5325,0.525246,0.58875,0.176,664,3698,4362,Summer,Clear,602,3698,4362,1,3,2,132
130,2011-05-10,2,0,5,0,2,1,1,0.5325,0.522721,0.489167,0.115671,694,4109,4803,Summer,Clear,601,4109,4803,1,3,3,133
131,2011-05-11,2,0,5,0,3,1,1,0.5425,0.5284,0.632917,0.120642,550,3632,4182,Summer,Clear,600,3632,4182,1,2,2,122
132,2011-05-12,2,0,5,0,4,1,1,0.535,0.523363,0.7475,0.189667,695,4169,4864,Summer,Clear,599,4169,4864,1,3,3,133
133,2011-05-13,2,0,5,0,5,1,2,0.5125,0.4943,0.863333,0.179725,692,3413,4105,Summer,Mist + Cloudy,598,3413,4105,1,2,2,122
134,2011-05-14,2,0,5,0,6,0,2,0.520833,0.500629,0.9225,0.13495,902,2507,3409,Summer,Mist + Cloudy,597,2507,3409,1,2,2,122
135,2011-05-15,2,0,5,0,0,0,2,0.5625,0.536,0.867083,0.152979,1582,2971,4553,Summer,Mist + Cloudy,596,2971,4553,1,2,3,123
136,2011-05-16,2,0,5,0,1,1,1,0.5775,0.550512,0.787917,0.126871,773,3185,3958,Summer,Clear,595,3185,3958,1,2,2,122
137,2011-05-17,2,0,5,0,2,1,2,0.561667,0.538529,0.837917,0.277354,678,3445,4123,Summer,Mist + Cloudy,594,3445,4123,1,2,2,122
138,2011-05-18,2,0,5,0,3,1,2,0.55,0.527158,0.87,0.201492,536,3319,3855,Summer,Mist + Cloudy,593,3319,3855,1,2,2,122
139,2011-05-19,2,0,5,0,4,1,2,0.530833,0.510742,0.829583,0.108213,735,3840,4575,Summer,Mist + Cloudy,592,3840,4575,1,3,3,133
140,2011-05-20,2,0,5,0,5,1,1,0.536667,0.529042,0.719583,0.125013,909,4008,4917,Summer,Clear,591,4008,4917,1,3,3,133
141,2011-05-21,2,0,5,0,6,0,1,0.6025,0.571975,0.626667,0.12065,2258,3547,5805,Summer,Clear,590,3547,5805,1,2,3,123
142,2011-05-22,2,0,5,0,0,0,1,0.604167,0.5745,0.749583,0.148008,1576,3084,4660,Summer,Clear,589,3084,4660,1,2,3,123
143,2011-05-23,2,0,5,0,1,1,2,0.631667,0.590296,0.81,0.233842,836,3438,4274,Summer,Mist + Cloudy,588,3438,4274,1,2,2,122
144,2011-05-24,2,0,5,0,2,1,2,0.66,0.604813,0.740833,0.207092,659,3833,4492,Summer,Mist + Cloudy,587,3833,4492,1,3,2,132
145,2011-05-25,2,0,5,0,3,1,1,0.660833,0.615542,0.69625,0.154233,740,4238,4978,Summer,Clear,586,4238,4978,1,3,3,133
146,2011-05-26,2,0,5,0,4,1,1,0.708333,0.654688,0.6775,0.199642,758,3919,4677,Summer,Clear,585,3919,4677,1,3,3,133
147,2011-05-27,2,0,5,0,5,1,1,0.681667,0.637008,0.65375,0.240679,871,3808,4679,Summer,Clear,584,3808,4679,1,3,3,133
148,2011-05-28,2,0,5,0,6,0,1,0.655833,0.612379,0.729583,0.230092,2001,2757,4758,Summer,Clear,583,2757,4758,1,2,3,123
149,2011-05-29,2,0,5,0,0,0,1,0.6675,0.61555,0.81875,0.213938,2355,2433,4788,Summer,Clear,582,2433,4788,1,1,3,113
150,2011-05-30,2,0,5,1,1,0,1,0.733333,0.671092,0.685,0.131225,1549,2549,4098,Summer,Clear,581,2549,4098,1,2,2,122
151,2011-05-31,2,0,5,0,2,1,1,0.775,0.725383,0.636667,0.111329,673,3309,3982,Summer,Clear,580,3309,3982,1,2,2,122
152,2011-06-01,2,0,6,0,3,1,2,0.764167,0.720967,0.677083,0.207092,513,3461,3974,Summer,Mist + Cloudy,579,3461,3974,1,2,2,122
153,2011-06-02,2,0,6,0,4,1,1,0.715,0.643942,0.305,0.292287,736,4232,4968,Summer,Clear,578,4232,4968,1,3,3,133
154,2011-06-03,2,0,6,0,5,1,1,0.62,0.587133,0.354167,0.253121,898,4414,5312,Summer,Clear,577,4414,5312,1,3,3,133
155,2011-06-04,2,0,6,0,6,0,1,0.635,0.594696,0.45625,0.123142,1869,3473,5342,Summer,Clear,576,3473,5342,1,2,3,123
156,2011-06-05,2,0,6,0,0,0,2,0.648333,0.616804,0.6525,0.138692,1685,3221,4906,Summer,Mist + Cloudy,575,3221,4906,1,2,3,123
157,2011-06-06,2,0,6,0,1,1,1,0.678333,0.621858,0.6,0.121896,673,3875,4548,Summer,Clear,574,3875,4548,1,3,2,132
158,2011-06-07,2,0,6,0,2,1,1,0.7075,0.65595,0.597917,0.187808,763,4070,4833,Summer,Clear,573,4070,4833,1,3,3,133
159,2011-06-08,2,0,6,0,3,1,1,0.775833,0.727279,0.622083,0.136817,676,3725,4401,Summer,Clear,572,3725,4401,1,3,2,132
160,2011-06-09,2,0,6,0,4,1,2,0.808333,0.757579,0.568333,0.149883,563,3352,3915,Summer,Mist + Cloudy,571,3352,3915,1,2,2,122
161,2011-06-10,2,0,6,0,5,1,1,0.755,0.703292,0.605,0.140554,815,3771,4586,Summer,Clear,570,3771,4586,1,3,3,133
162,2011-06-11,2,0,6,0,6,0,1,0.725,0.678038,0.654583,0.15485,1729,3237,4966,Summer,Clear,569,3237,4966,1,2,3,123
163,2011-06-12,2,0,6,0,0,0,1,0.6925,0.643325,0.747917,0.163567,1467,2993,4460,Summer,Clear,568,2993,4460,1,2,2,122
164,2011-06-13,2,0,6,0,1,1,1,0.635,0.601654,0.494583,0.30535,863,4157,5020,Summer,Clear,567,4157,5020,1,3,3,133
165,2011-06-14,2,0,6,0,2,1,1,0.604167,0.591546,0.507083,0.269283,727,4164,4891,Summer,Clear,566,4164,4891,1,3,3,133
166,2011-06-15,2,0,6,0,3,1,1,0.626667,0.587754,0.471667,0.167912,769,4411,5180,Summer,Clear,565,4411,5180,1,3,3,133
167,2011-06-16,2,0,6,0,4,1,2,0.628333,0.595346,0.688333,0.206471,545,3222,3767,Summer,Mist + Cloudy,564,3222,3767,1,2,2,122
168,2011-06-17,2,0,6,0,5,1,1,0.649167,0.600383,0.735833,0.143029,863,3981,4844,Summer,Clear,563,3981,4844,1,3,3,133
169,2011-06-18,2,0,6,0,6,0,1,0.696667,0.643954,0.670417,0.119408,1807,3312,5119,Summer,Clear,562,3312,5119,1,2,3,123
170,2011-06-19,2,0,6,0,0,0,2,0.699167,0.645846,0.666667,0.102,1639,3105,4744,Summer,Mist + Cloudy,561,3105,4744,1,2,3,123
171,2011-06-20,2,0,6,0,1,1,2,0.635,0.595346,0.74625,0.155475,699,3311,4010,Summer,Mist + Cloudy,560,3311,4010,1,2,2,122
172,2011-06-21,3,0,6,0,2,1,2,0.680833,0.637646,0.770417,0.171025,774,4061,4835,Fall,Mist + Cloudy,559,4061,4835,1,3,3,133
173,2011-06-22,3,0,6,0,3,1,1,0.733333,0.693829,0.7075,0.172262,661,3846,4507,Fall,Clear,558,3846,4507,1,3,2,132
174,2011-06-23,3,0,6,0,4,1,2,0.728333,0.693833,0.703333,0.238804,746,4044,4790,Fall,Mist + Cloudy,557,4044,4790,1,3,3,133
175,2011-06-24,3,0,6,0,5,1,1,0.724167,0.656583,0.573333,0.222025,969,4022,4991,Fall,Clear,556,4022,4991,1,3,3,133
176,2011-06-25,3,0,6,0,6,0,1,0.695,0.643313,0.483333,0.209571,1782,3420,5202,Fall,Clear,555,3420,5202,1,2,3,123
177,2011-06-26,3,0,6,0,0,0,1,0.68,0.637629,0.513333,0.0945333,1920,3385,5305,Fall,Clear,554,3385,5305,1,2,3,123
178,2011-06-27,3,0,6,0,1,1,2,0.6825,0.637004,0.658333,0.107588,854,3854,4708,Fall,Mist + Cloudy,553,3854,4708,1,3,3,133
179,2011-06-28,3,0,6,0,2,1,1,0.744167,0.692558,0.634167,0.144283,732,3916,4648,Fall,Clear,552,3916,4648,1,3,3,133
180,2011-06-29,3,0,6,0,3,1,1,0.728333,0.654688,0.497917,0.261821,848,4377,5225,Fall,Clear,551,4377,5225,1,3,3,133
181,2011-06-30,3,0,6,0,4,1,1,0.696667,0.637008,0.434167,0.185312,1027,4488,5515,Fall,Clear,550,4488,5515,1,3,3,133
182,2011-07-01,3,0,7,0,5,1,1,0.7225,0.652162,0.39625,0.102608,1246,4116,5362,Fall,Clear,549,4116,5362,1,3,3,133
183,2011-07-02,3,0,7,0,6,0,1,0.738333,0.667308,0.444583,0.115062,2204,2915,5119,Fall,Clear,548,2915,5119,1,2,3,123
184,2011-07-03,3,0,7,0,0,0,2,0.716667,0.668575,0.6825,0.228858,2282,2367,4649,Fall,Mist + Cloudy,547,2367,4649,2,1,3,213
185,2011-07-04,3,0,7,1,1,0,2,0.726667,0.665417,0.637917,0.0814792,3065,2978,6043,Fall,Mist + Cloudy,546,2978,6043,2,2,4,224
186,2011-07-05,3,0,7,0,2,1,1,0.746667,0.696338,0.590417,0.126258,1031,3634,4665,Fall,Clear,545,3634,4665,2,2,3,223
187,2011-07-06,3,0,7,0,3,1,1,0.72,0.685633,0.743333,0.149883,784,3845,4629,Fall,Clear,544,3845,4629,2,3,3,233
188,2011-07-07,3,0,7,0,4,1,1,0.75,0.686871,0.65125,0.1592,754,3838,4592,Fall,Clear,543,3838,4592,2,3,3,233
189,2011-07-08,3,0,7,0,5,1,2,0.709167,0.670483,0.757917,0.225129,692,3348,4040,Fall,Mist + Cloudy,542,3348,4040,2,2,2,222
190,2011-07-09,3,0,7,0,6,0,1,0.733333,0.664158,0.609167,0.167912,1988,3348,5336,Fall,Clear,541,3348,5336,2,2,3,223
191,2011-07-10,3,0,7,0,0,0,1,0.7475,0.690025,0.578333,0.183471,1743,3138,4881,Fall,Clear,540,3138,4881,2,2,3,223
192,2011-07-11,3,0,7,0,1,1,1,0.7625,0.729804,0.635833,0.282337,723,3363,4086,Fall,Clear,539,3363,4086,2,2,2,222
193,2011-07-12,3,0,7,0,2,1,1,0.794167,0.739275,0.559167,0.200254,662,3596,4258,Fall,Clear,538,3596,4258,2,2,2,222
194,2011-07-13,3,0,7,0,3,1,1,0.746667,0.689404,0.631667,0.146133,748,3594,4342,Fall,Clear,537,3594,4342,2,2,2,222
195,2011-07-14,3,0,7,0,4,1,1,0.680833,0.635104,0.47625,0.240667,888,4196,5084,Fall,Clear,536,4196,5084,2,3,3,233
196,2011-07-15,3,0,7,0,5,1,1,0.663333,0.624371,0.59125,0.182833,1318,4220,5538,Fall,Clear,535,4220,5538,2,3,3,233
197,2011-07-16,3,0,7,0,6,0,1,0.686667,0.638263,0.585,0.208342,2418,3505,5923,Fall,Clear,534,3505,5923,2,2,3,223
198,2011-07-17,3,0,7,0,0,0,1,0.719167,0.669833,0.604167,0.245033,2006,3296,5302,Fall,Clear,533,3296,5302,2,2,3,223
199,2011-07-18,3,0,7,0,1,1,1,0.746667,0.703925,0.65125,0.215804,841,3617,4458,Fall,Clear,532,3617,4458,2,2,2,222
200,2011-07-19,3,0,7,0,2,1,1,0.776667,0.747479,0.650417,0.1306,752,3789,4541,Fall,Clear,531,3789,4541,2,3,2,232
201,2011-07-20,3,0,7,0,3,1,1,0.768333,0.74685,0.707083,0.113817,644,3688,4332,Fall,Clear,530,3688,4332,2,3,2,232
202,2011-07-21,3,0,7,0,4,1,2,0.815,0.826371,0.69125,0.222021,632,3152,3784,Fall,Mist + Cloudy,529,3152,3784,2,2,2,222
203,2011-07-22,3,0,7,0,5,1,1,0.848333,0.840896,0.580417,0.1331,562,2825,3387,Fall,Clear,528,2825,3387,2,2,2,222
204,2011-07-23,3,0,7,0,6,0,1,0.849167,0.804287,0.5,0.131221,987,2298,3285,Fall,Clear,527,2298,3285,2,1,2,212
205,2011-07-24,3,0,7,0,0,0,1,0.83,0.794829,0.550833,0.169171,1050,2556,3606,Fall,Clear,526,2556,3606,2,2,2,222
206,2011-07-25,3,0,7,0,1,1,1,0.743333,0.720958,0.757083,0.0908083,568,3272,3840,Fall,Clear,525,3272,3840,2,2,2,222
207,2011-07-26,3,0,7,0,2,1,1,0.771667,0.696979,0.540833,0.200258,750,3840,4590,Fall,Clear,524,3840,4590,2,3,3,233
208,2011-07-27,3,0,7,0,3,1,1,0.775,0.690667,0.402917,0.183463,755,3901,4656,Fall,Clear,523,3901,4656,2,3,3,233
209,2011-07-28,3,0,7,0,4,1,1,0.779167,0.7399,0.583333,0.178479,606,3784,4390,Fall,Clear,522,3784,4390,2,3,2,232
210,2011-07-29,3,0,7,0,5,1,1,0.838333,0.785967,0.5425,0.174138,670,3176,3846,Fall,Clear,521,3176,3846,2,2,2,222
211,2011-07-30,3,0,7,0,6,0,1,0.804167,0.728537,0.465833,0.168537,1559,2916,4475,Fall,Clear,520,2916,4475,2,2,2,222
212,2011-07-31,3,0,7,0,0,0,1,0.805833,0.729796,0.480833,0.164813,1524,2778,4302,Fall,Clear,519,2778,4302,2,2,2,222
213,2011-08-01,3,0,8,0,1,1,1,0.771667,0.703292,0.550833,0.156717,729,3537,4266,Fall,Clear,518,3537,4266,2,2,2,222
214,2011-08-02,3,0,8,0,2,1,1,0.783333,0.707071,0.49125,0.20585,801,4044,4845,Fall,Clear,517,4044,4845,2,3,3,233
215,2011-08-03,3,0,8,0,3,1,2,0.731667,0.679937,0.6575,0.135583,467,3107,3574,Fall,Mist + Cloudy,516,3107,3574,2,2,2,222
216,2011-08-04,3,0,8,0,4,1,2,0.71,0.664788,0.7575,0.19715,799,3777,4576,Fall,Mist + Cloudy,515,3777,4576,2,3,3,233
217,2011-08-05,3,0,8,0,5,1,1,0.710833,0.656567,0.630833,0.184696,1023,3843,4866,Fall,Clear,514,3843,4866,2,3,3,233
218,2011-08-06,3,0,8,0,6,0,2,0.716667,0.676154,0.755,0.22825,1521,2773,4294,Fall,Mist + Cloudy,513,2773,4294,2,2,2,222
219,2011-08-07,3,0,8,0,0,0,1,0.7425,0.715292,0.752917,0.201487,1298,2487,3785,Fall,Clear,512,2487,3785,2,1,2,212
220,2011-08-08,3,0,8,0,1,1,1,0.765,0.703283,0.592083,0.192175,846,3480,4326,Fall,Clear,511,3480,4326,2,2,2,222
221,2011-08-09,3,0,8,0,2,1,1,0.775,0.724121,0.570417,0.151121,907,3695,4602,Fall,Clear,510,3695,4602,2,3,3,233
222,2011-08-10,3,0,8,0,3,1,1,0.766667,0.684983,0.424167,0.200258,884,3896,4780,Fall,Clear,509,3896,4780,2,3,3,233
223,2011-08-11,3,0,8,0,4,1,1,0.7175,0.651521,0.42375,0.164796,812,3980,4792,Fall,Clear,508,3980,4792,2,3,3,233
224,2011-08-12,3,0,8,0,5,1,1,0.708333,0.654042,0.415,0.125621,1051,3854,4905,Fall,Clear,507,3854,4905,2,3,3,233
225,2011-08-13,3,0,8,0,6,0,2,0.685833,0.645858,0.729583,0.211454,1504,2646,4150,Fall,Mist + Cloudy,506,2646,4150,2,2,2,222
226,2011-08-14,3,0,8,0,0,0,2,0.676667,0.624388,0.8175,0.222633,1338,2482,3820,Fall,Mist + Cloudy,505,2482,3820,2,1,2,212
227,2011-08-15,3,0,8,0,1,1,1,0.665833,0.616167,0.712083,0.208954,775,3563,4338,Fall,Clear,504,3563,4338,2,2,2,222
228,2011-08-16,3,0,8,0,2,1,1,0.700833,0.645837,0.578333,0.236329,721,4004,4725,Fall,Clear,503,4004,4725,2,3,3,233
229,2011-08-17,3,0,8,0,3,1,1,0.723333,0.666671,0.575417,0.143667,668,4026,4694,Fall,Clear,502,4026,4694,2,3,3,233
230,2011-08-18,3,0,8,0,4,1,1,0.711667,0.662258,0.654583,0.233208,639,3166,3805,Fall,Clear,501,3166,3805,2,2,2,222
231,2011-08-19,3,0,8,0,5,1,2,0.685,0.633221,0.722917,0.139308,797,3356,4153,Fall,Mist + Cloudy,500,3356,4153,2,2,2,222
232,2011-08-20,3,0,8,0,6,0,1,0.6975,0.648996,0.674167,0.104467,1914,3277,5191,Fall,Clear,499,3277,5191,2,2,3,223
233,2011-08-21,3,0,8,0,0,0,1,0.710833,0.675525,0.77,0.248754,1249,2624,3873,Fall,Clear,498,2624,3873,2,2,2,222
234,2011-08-22,3,0,8,0,1,1,1,0.691667,0.638254,0.47,0.27675,833,3925,4758,Fall,Clear,497,3925,4758,2,3,3,233
235,2011-08-23,3,0,8,0,2,1,1,0.640833,0.606067,0.455417,0.146763,1281,4614,5895,Fall,Clear,496,4614,5895,2,3,3,233
236,2011-08-24,3,0,8,0,3,1,1,0.673333,0.630692,0.605,0.253108,949,4181,5130,Fall,Clear,495,4181,5130,2,3,3,233
237,2011-08-25,3,0,8,0,4,1,2,0.684167,0.645854,0.771667,0.210833,435,3107,3542,Fall,Mist + Cloudy,494,3107,3542,2,2,2,222
238,2011-08-26,3,0,8,0,5,1,1,0.7,0.659733,0.76125,0.0839625,768,3893,4661,Fall,Clear,493,3893,4661,2,3,3,233
239,2011-08-27,3,0,8,0,6,0,2,0.68,0.635556,0.85,0.375617,226,889,1115,Fall,Mist + Cloudy,492,889,1115,2,1,1,211
240,2011-08-28,3,0,8,0,0,0,1,0.707059,0.647959,0.561765,0.304659,1415,2919,4334,Fall,Clear,491,2919,4334,2,2,2,222
241,2011-08-29,3,0,8,0,1,1,1,0.636667,0.607958,0.554583,0.159825,729,3905,4634,Fall,Clear,490,3905,4634,2,3,3,233
242,2011-08-30,3,0,8,0,2,1,1,0.639167,0.594704,0.548333,0.125008,775,4429,5204,Fall,Clear,489,4429,5204,2,3,3,233
243,2011-08-31,3,0,8,0,3,1,1,0.656667,0.611121,0.597917,0.0833333,688,4370,5058,Fall,Clear,488,4370,5058,2,3,3,233
244,2011-09-01,3,0,9,0,4,1,1,0.655,0.614921,0.639167,0.141796,783,4332,5115,Fall,Clear,487,4332,5115,2,3,3,233
245,2011-09-02,3,0,9,0,5,1,2,0.643333,0.604808,0.727083,0.139929,875,3852,4727,Fall,Mist + Cloudy,486,3852,4727,2,3,3,233
246,2011-09-03,3,0,9,0,6,0,1,0.669167,0.633213,0.716667,0.185325,1935,2549,4484,Fall,Clear,485,2549,4484,2,2,2,222
247,2011-09-04,3,0,9,0,0,0,1,0.709167,0.665429,0.742083,0.206467,2521,2419,4940,Fall,Clear,484,2419,4940,2,1,3,213
248,2011-09-05,3,0,9,1,1,0,2,0.673333,0.625646,0.790417,0.212696,1236,2115,3351,Fall,Mist + Cloudy,483,2115,3351,2,1,2,212
249,2011-09-06,3,0,9,0,2,1,3,0.54,0.5152,0.886957,0.343943,204,2506,2710,Fall,Light Snow/Rain,482,2506,2710,2,2,1,221
250,2011-09-07,3,0,9,0,3,1,3,0.599167,0.544229,0.917083,0.0970208,118,1878,1996,Fall,Light Snow/Rain,481,1878,1996,2,1,1,211
251,2011-09-08,3,0,9,0,4,1,3,0.633913,0.555361,0.939565,0.192748,153,1689,1842,Fall,Light Snow/Rain,480,1689,1842,2,1,1,211
252,2011-09-09,3,0,9,0,5,1,2,0.65,0.578946,0.897917,0.124379,417,3127,3544,Fall,Mist + Cloudy,479,3127,3544,2,2,2,222
253,2011-09-10,3,0,9,0,6,0,1,0.66,0.607962,0.75375,0.153608,1750,3595,5345,Fall,Clear,478,3595,5345,2,2,3,223
254,2011-09-11,3,0,9,0,0,0,1,0.653333,0.609229,0.71375,0.115054,1633,3413,5046,Fall,Clear,477,3413,5046,2,2,3,223
255,2011-09-12,3,0,9,0,1,1,1,0.644348,0.60213,0.692174,0.088913,690,4023,4713,Fall,Clear,476,4023,4713,2,3,3,233
256,2011-09-13,3,0,9,0,2,1,1,0.650833,0.603554,0.7125,0.141804,701,4062,4763,Fall,Clear,475,4062,4763,2,3,3,233
257,2011-09-14,3,0,9,0,3,1,1,0.673333,0.6269,0.697083,0.1673,647,4138,4785,Fall,Clear,474,4138,4785,2,3,3,233
258,2011-09-15,3,0,9,0,4,1,2,0.5775,0.553671,0.709167,0.271146,428,3231,3659,Fall,Mist + Cloudy,473,3231,3659,2,2,2,222
259,2011-09-16,3,0,9,0,5,1,2,0.469167,0.461475,0.590417,0.164183,742,4018,4760,Fall,Mist + Cloudy,472,4018,4760,2,3,3,233
260,2011-09-17,3,0,9,0,6,0,2,0.491667,0.478512,0.718333,0.189675,1434,3077,4511,Fall,Mist + Cloudy,471,3077,4511,2,2,2,222
261,2011-09-18,3,0,9,0,0,0,1,0.5075,0.490537,0.695,0.178483,1353,2921,4274,Fall,Clear,470,2921,4274,2,2,2,222
262,2011-09-19,3,0,9,0,1,1,2,0.549167,0.529675,0.69,0.151742,691,3848,4539,Fall,Mist + Cloudy,469,3848,4539,2,3,2,232
263,2011-09-20,3,0,9,0,2,1,2,0.561667,0.532217,0.88125,0.134954,438,3203,3641,Fall,Mist + Cloudy,468,3203,3641,2,2,2,222
264,2011-09-21,3,0,9,0,3,1,2,0.595,0.550533,0.9,0.0964042,539,3813,4352,Fall,Mist + Cloudy,467,3813,4352,2,3,2,232
265,2011-09-22,3,0,9,0,4,1,2,0.628333,0.554963,0.902083,0.128125,555,4240,4795,Fall,Mist + Cloudy,466,4240,4795,2,3,3,233
266,2011-09-23,4,0,9,0,5,1,2,0.609167,0.522125,0.9725,0.0783667,258,2137,2395,Winter,Mist + Cloudy,465,2137,2395,2,1,1,211
267,2011-09-24,4,0,9,0,6,0,2,0.606667,0.564412,0.8625,0.0783833,1776,3647,5423,Winter,Mist + Cloudy,464,3647,5423,2,2,3,223
268,2011-09-25,4,0,9,0,0,0,2,0.634167,0.572637,0.845,0.0503792,1544,3466,5010,Winter,Mist + Cloudy,463,3466,5010,2,2,3,223
269,2011-09-26,4,0,9,0,1,1,2,0.649167,0.589042,0.848333,0.1107,684,3946,4630,Winter,Mist + Cloudy,462,3946,4630,2,3,3,233
270,2011-09-27,4,0,9,0,2,1,2,0.636667,0.574525,0.885417,0.118171,477,3643,4120,Winter,Mist + Cloudy,461,3643,4120,2,2,2,222
271,2011-09-28,4,0,9,0,3,1,2,0.635,0.575158,0.84875,0.148629,480,3427,3907,Winter,Mist + Cloudy,460,3427,3907,2,2,2,222
272,2011-09-29,4,0,9,0,4,1,1,0.616667,0.574512,0.699167,0.172883,653,4186,4839,Winter,Clear,459,4186,4839,2,3,3,233
273,2011-09-30,4,0,9,0,5,1,1,0.564167,0.544829,0.6475,0.206475,830,4372,5202,Winter,Clear,458,4372,5202,2,3,3,233
274,2011-10-01,4,0,10,0,6,0,2,0.41,0.412863,0.75375,0.292296,480,1949,2429,Winter,Mist + Cloudy,457,1949,2429,2,1,1,211
275,2011-10-02,4,0,10,0,0,0,2,0.356667,0.345317,0.791667,0.222013,616,2302,2918,Winter,Mist + Cloudy,456,2302,2918,2,1,1,211
276,2011-10-03,4,0,10,0,1,1,2,0.384167,0.392046,0.760833,0.0833458,330,3240,3570,Winter,Mist + Cloudy,455,3240,3570,2,2,2,222
277,2011-10-04,4,0,10,0,2,1,1,0.484167,0.472858,0.71,0.205854,486,3970,4456,Winter,Clear,454,3970,4456,2,3,2,232
278,2011-10-05,4,0,10,0,3,1,1,0.538333,0.527138,0.647917,0.17725,559,4267,4826,Winter,Clear,453,4267,4826,2,3,3,233
279,2011-10-06,4,0,10,0,4,1,1,0.494167,0.480425,0.620833,0.134954,639,4126,4765,Winter,Clear,452,4126,4765,2,3,3,233
280,2011-10-07,4,0,10,0,5,1,1,0.510833,0.504404,0.684167,0.0223917,949,4036,4985,Winter,Clear,451,4036,4985,2,3,3,233
281,2011-10-08,4,0,10,0,6,0,1,0.521667,0.513242,0.70125,0.0454042,2235,3174,5409,Winter,Clear,450,3174,5409,2,2,3,223
282,2011-10-09,4,0,10,0,0,0,1,0.540833,0.523983,0.7275,0.06345,2397,3114,5511,Winter,Clear,449,3114,5511,2,2,3,223
283,2011-10-10,4,0,10,1,1,0,1,0.570833,0.542925,0.73375,0.0423042,1514,3603,5117,Winter,Clear,448,3603,5117,2,2,3,223
284,2011-10-11,4,0,10,0,2,1,2,0.566667,0.546096,0.80875,0.143042,667,3896,4563,Winter,Mist + Cloudy,447,3896,4563,2,3,3,233
285,2011-10-12,4,0,10,0,3,1,3,0.543333,0.517717,0.90625,0.24815,217,2199,2416,Winter,Light Snow/Rain,446,2199,2416,2,1,1,211
286,2011-10-13,4,0,10,0,4,1,2,0.589167,0.551804,0.896667,0.141787,290,2623,2913,Winter,Mist + Cloudy,445,2623,2913,2,2,1,221
287,2011-10-14,4,0,10,0,5,1,2,0.550833,0.529675,0.71625,0.223883,529,3115,3644,Winter,Mist + Cloudy,444,3115,3644,2,2,2,222
288,2011-10-15,4,0,10,0,6,0,1,0.506667,0.498725,0.483333,0.258083,1899,3318,5217,Winter,Clear,443,3318,5217,2,2,3,223
289,2011-10-16,4,0,10,0,0,0,1,0.511667,0.503154,0.486667,0.281717,1748,3293,5041,Winter,Clear,442,3293,5041,2,2,3,223
290,2011-10-17,4,0,10,0,1,1,1,0.534167,0.510725,0.579583,0.175379,713,3857,4570,Winter,Clear,441,3857,4570,2,3,3,233
291,2011-10-18,4,0,10,0,2,1,2,0.5325,0.522721,0.701667,0.110087,637,4111,4748,Winter,Mist + Cloudy,440,4111,4748,2,3,3,233
292,2011-10-19,4,0,10,0,3,1,3,0.541739,0.513848,0.895217,0.243339,254,2170,2424,Winter,Light Snow/Rain,439,2170,2424,2,1,1,211
293,2011-10-20,4,0,10,0,4,1,1,0.475833,0.466525,0.63625,0.422275,471,3724,4195,Winter,Clear,438,3724,4195,2,3,2,232
294,2011-10-21,4,0,10,0,5,1,1,0.4275,0.423596,0.574167,0.221396,676,3628,4304,Winter,Clear,437,3628,4304,2,2,2,222
295,2011-10-22,4,0,10,0,6,0,1,0.4225,0.425492,0.629167,0.0926667,1499,2809,4308,Winter,Clear,436,2809,4308,2,2,2,222
296,2011-10-23,4,0,10,0,0,0,1,0.421667,0.422333,0.74125,0.0995125,1619,2762,4381,Winter,Clear,435,2762,4381,2,2,2,222
297,2011-10-24,4,0,10,0,1,1,1,0.463333,0.457067,0.772083,0.118792,699,3488,4187,Winter,Clear,434,3488,4187,2,2,2,222
298,2011-10-25,4,0,10,0,2,1,1,0.471667,0.463375,0.622917,0.166658,695,3992,4687,Winter,Clear,433,3992,4687,2,3,3,233
299,2011-10-26,4,0,10,0,3,1,2,0.484167,0.472846,0.720417,0.148642,404,3490,3894,Winter,Mist + Cloudy,432,3490,3894,2,2,2,222
300,2011-10-27,4,0,10,0,4,1,2,0.47,0.457046,0.812917,0.197763,240,2419,2659,Winter,Mist + Cloudy,431,2419,2659,2,1,1,211
301,2011-10-28,4,0,10,0,5,1,2,0.330833,0.318812,0.585833,0.229479,456,3291,3747,Winter,Mist + Cloudy,430,3291,3747,2,2,2,222
302,2011-10-29,4,0,10,0,6,0,3,0.254167,0.227913,0.8825,0.351371,57,570,627,Winter,Light Snow/Rain,429,570,627,2,1,1,211
303,2011-10-30,4,0,10,0,0,0,1,0.319167,0.321329,0.62375,0.176617,885,2446,3331,Winter,Clear,428,2446,3331,2,1,2,212
304,2011-10-31,4,0,10,0,1,1,1,0.34,0.356063,0.703333,0.10635,362,3307,3669,Winter,Clear,427,3307,3669,2,2,2,222
305,2011-11-01,4,0,11,0,2,1,1,0.400833,0.397088,0.68375,0.135571,410,3658,4068,Winter,Clear,426,3658,4068,2,2,2,222
306,2011-11-02,4,0,11,0,3,1,1,0.3775,0.390133,0.71875,0.0820917,370,3816,4186,Winter,Clear,425,3816,4186,2,3,2,232
307,2011-11-03,4,0,11,0,4,1,1,0.408333,0.405921,0.702083,0.136817,318,3656,3974,Winter,Clear,424,3656,3974,2,2,2,222
308,2011-11-04,4,0,11,0,5,1,2,0.403333,0.403392,0.6225,0.271779,470,3576,4046,Winter,Mist + Cloudy,423,3576,4046,2,2,2,222
309,2011-11-05,4,0,11,0,6,0,1,0.326667,0.323854,0.519167,0.189062,1156,2770,3926,Winter,Clear,422,2770,3926,2,2,2,222
310,2011-11-06,4,0,11,0,0,0,1,0.348333,0.362358,0.734583,0.0920542,952,2697,3649,Winter,Clear,421,2697,3649,2,2,2,222
311,2011-11-07,4,0,11,0,1,1,1,0.395,0.400871,0.75875,0.057225,373,3662,4035,Winter,Clear,420,3662,4035,2,2,2,222
312,2011-11-08,4,0,11,0,2,1,1,0.408333,0.412246,0.721667,0.0690375,376,3829,4205,Winter,Clear,419,3829,4205,2,3,2,232
313,2011-11-09,4,0,11,0,3,1,1,0.4,0.409079,0.758333,0.0621958,305,3804,4109,Winter,Clear,418,3804,4109,2,3,2,232
314,2011-11-10,4,0,11,0,4,1,2,0.38,0.373721,0.813333,0.189067,190,2743,2933,Winter,Mist + Cloudy,417,2743,2933,2,2,1,221
315,2011-11-11,4,0,11,1,5,0,1,0.324167,0.306817,0.44625,0.314675,440,2928,3368,Winter,Clear,416,2928,3368,2,2,2,222
316,2011-11-12,4,0,11,0,6,0,1,0.356667,0.357942,0.552917,0.212062,1275,2792,4067,Winter,Clear,415,2792,4067,2,2,2,222
317,2011-11-13,4,0,11,0,0,0,1,0.440833,0.43055,0.458333,0.281721,1004,2713,3717,Winter,Clear,414,2713,3717,2,2,2,222
318,2011-11-14,4,0,11,0,1,1,1,0.53,0.524612,0.587083,0.306596,595,3891,4486,Winter,Clear,413,3891,4486,2,3,2,232
319,2011-11-15,4,0,11,0,2,1,2,0.53,0.507579,0.68875,0.199633,449,3746,4195,Winter,Mist + Cloudy,412,3746,4195,2,3,2,232
320,2011-11-16,4,0,11,0,3,1,3,0.456667,0.451988,0.93,0.136829,145,1672,1817,Winter,Light Snow/Rain,411,1672,1817,2,1,1,211
321,2011-11-17,4,0,11,0,4,1,2,0.341667,0.323221,0.575833,0.305362,139,2914,3053,Winter,Mist + Cloudy,410,2914,3053,2,2,1,221
322,2011-11-18,4,0,11,0,5,1,1,0.274167,0.272721,0.41,0.168533,245,3147,3392,Winter,Clear,409,3147,3392,2,2,2,222
323,2011-11-19,4,0,11,0,6,0,1,0.329167,0.324483,0.502083,0.224496,943,2720,3663,Winter,Clear,408,2720,3663,2,2,2,222
324,2011-11-20,4,0,11,0,0,0,2,0.463333,0.457058,0.684583,0.18595,787,2733,3520,Winter,Mist + Cloudy,407,2733,3520,2,2,2,222
325,2011-11-21,4,0,11,0,1,1,3,0.4475,0.445062,0.91,0.138054,220,2545,2765,Winter,Light Snow/Rain,406,2545,2765,2,2,1,221
326,2011-11-22,4,0,11,0,2,1,3,0.416667,0.421696,0.9625,0.118792,69,1538,1607,Winter,Light Snow/Rain,405,1538,1607,2,1,1,211
327,2011-11-23,4,0,11,0,3,1,2,0.440833,0.430537,0.757917,0.335825,112,2454,2566,Winter,Mist + Cloudy,404,2454,2566,2,1,1,211
328,2011-11-24,4,0,11,1,4,0,1,0.373333,0.372471,0.549167,0.167304,560,935,1495,Winter,Clear,403,935,1495,2,1,1,211
329,2011-11-25,4,0,11,0,5,1,1,0.375,0.380671,0.64375,0.0988958,1095,1697,2792,Winter,Clear,402,1697,2792,2,1,1,211
330,2011-11-26,4,0,11,0,6,0,1,0.375833,0.385087,0.681667,0.0684208,1249,1819,3068,Winter,Clear,401,1819,3068,2,1,1,211
331,2011-11-27,4,0,11,0,0,0,1,0.459167,0.4558,0.698333,0.208954,810,2261,3071,Winter,Clear,400,2261,3071,2,1,1,211
332,2011-11-28,4,0,11,0,1,1,1,0.503478,0.490122,0.743043,0.142122,253,3614,3867,Winter,Clear,399,3614,3867,2,2,2,222
333,2011-11-29,4,0,11,0,2,1,2,0.458333,0.451375,0.830833,0.258092,96,2818,2914,Winter,Mist + Cloudy,398,2818,2914,2,2,1,221
334,2011-11-30,4,0,11,0,3,1,1,0.325,0.311221,0.613333,0.271158,188,3425,3613,Winter,Clear,397,3425,3613,2,2,2,222
335,2011-12-01,4,0,12,0,4,1,1,0.3125,0.305554,0.524583,0.220158,182,3545,3727,Winter,Clear,396,3545,3727,2,2,2,222
336,2011-12-02,4,0,12,0,5,1,1,0.314167,0.331433,0.625833,0.100754,268,3672,3940,Winter,Clear,395,3672,3940,2,3,2,232
337,2011-12-03,4,0,12,0,6,0,1,0.299167,0.310604,0.612917,0.0957833,706,2908,3614,Winter,Clear,394,2908,3614,2,2,2,222
338,2011-12-04,4,0,12,0,0,0,1,0.330833,0.3491,0.775833,0.0839583,634,2851,3485,Winter,Clear,393,2851,3485,2,2,2,222
339,2011-12-05,4,0,12,0,1,1,2,0.385833,0.393925,0.827083,0.0622083,233,3578,3811,Winter,Mist + Cloudy,392,3578,3811,2,2,2,222
340,2011-12-06,4,0,12,0,2,1,3,0.4625,0.4564,0.949583,0.232583,126,2468,2594,Winter,Light Snow/Rain,391,2468,2594,2,1,1,211
341,2011-12-07,4,0,12,0,3,1,3,0.41,0.400246,0.970417,0.266175,50,655,705,Winter,Light Snow/Rain,390,655,705,2,1,1,211
342,2011-12-08,4,0,12,0,4,1,1,0.265833,0.256938,0.58,0.240058,150,3172,3322,Winter,Clear,389,3172,3322,2,2,2,222
343,2011-12-09,4,0,12,0,5,1,1,0.290833,0.317542,0.695833,0.0827167,261,3359,3620,Winter,Clear,388,3359,3620,2,2,2,222
344,2011-12-10,4,0,12,0,6,0,1,0.275,0.266412,0.5075,0.233221,502,2688,3190,Winter,Clear,387,2688,3190,2,2,2,222
345,2011-12-11,4,0,12,0,0,0,1,0.220833,0.253154,0.49,0.0665417,377,2366,2743,Winter,Clear,386,2366,2743,2,1,1,211
346,2011-12-12,4,0,12,0,1,1,1,0.238333,0.270196,0.670833,0.06345,143,3167,3310,Winter,Clear,385,3167,3310,2,2,2,222
347,2011-12-13,4,0,12,0,2,1,1,0.2825,0.301138,0.59,0.14055,155,3368,3523,Winter,Clear,384,3368,3523,2,2,2,222
348,2011-12-14,4,0,12,0,3,1,2,0.3175,0.338362,0.66375,0.0609583,178,3562,3740,Winter,Mist + Cloudy,383,3562,3740,2,2,2,222
349,2011-12-15,4,0,12,0,4,1,2,0.4225,0.412237,0.634167,0.268042,181,3528,3709,Winter,Mist + Cloudy,382,3528,3709,2,2,2,222
350,2011-12-16,4,0,12,0,5,1,2,0.375,0.359825,0.500417,0.260575,178,3399,3577,Winter,Mist + Cloudy,381,3399,3577,2,2,2,222
351,2011-12-17,4,0,12,0,6,0,2,0.258333,0.249371,0.560833,0.243167,275,2464,2739,Winter,Mist + Cloudy,380,2464,2739,2,1,1,211
352,2011-12-18,4,0,12,0,0,0,1,0.238333,0.245579,0.58625,0.169779,220,2211,2431,Winter,Clear,379,2211,2431,2,1,1,211
353,2011-12-19,4,0,12,0,1,1,1,0.276667,0.280933,0.6375,0.172896,260,3143,3403,Winter,Clear,378,3143,3403,2,2,2,222
354,2011-12-20,4,0,12,0,2,1,2,0.385833,0.396454,0.595417,0.0615708,216,3534,3750,Winter,Mist + Cloudy,377,3534,3750,2,2,2,222
355,2011-12-21,1,0,12,0,3,1,2,0.428333,0.428017,0.858333,0.2214,107,2553,2660,Spring,Mist + Cloudy,376,2553,2660,2,2,1,221
356,2011-12-22,1,0,12,0,4,1,2,0.423333,0.426121,0.7575,0.047275,227,2841,3068,Spring,Mist + Cloudy,375,2841,3068,2,2,1,221
357,2011-12-23,1,0,12,0,5,1,1,0.373333,0.377513,0.68625,0.274246,163,2046,2209,Spring,Clear,374,2046,2209,2,1,1,211
358,2011-12-24,1,0,12,0,6,0,1,0.3025,0.299242,0.5425,0.190304,155,856,1011,Spring,Clear,373,856,1011,2,1,1,211
359,2011-12-25,1,0,12,0,0,0,1,0.274783,0.279961,0.681304,0.155091,303,451,754,Spring,Clear,372,451,754,2,1,1,211
360,2011-12-26,1,0,12,1,1,0,1,0.321739,0.315535,0.506957,0.239465,430,887,1317,Spring,Clear,371,887,1317,2,1,1,211
361,2011-12-27,1,0,12,0,2,1,2,0.325,0.327633,0.7625,0.18845,103,1059,1162,Spring,Mist + Cloudy,370,1059,1162,2,1,1,211
362,2011-12-28,1,0,12,0,3,1,1,0.29913,0.279974,0.503913,0.293961,255,2047,2302,Spring,Clear,369,2047,2302,2,1,1,211
363,2011-12-29,1,0,12,0,4,1,1,0.248333,0.263892,0.574167,0.119412,254,2169,2423,Spring,Clear,368,2169,2423,2,1,1,211
364,2011-12-30,1,0,12,0,5,1,1,0.311667,0.318812,0.636667,0.134337,491,2508,2999,Spring,Clear,367,2508,2999,2,2,1,221
365,2011-12-31,1,0,12,0,6,0,1,0.41,0.414121,0.615833,0.220154,665,1820,2485,Spring,Clear,366,1820,2485,2,1,1,211
366,2012-01-01,1,1,1,0,0,0,1,0.37,0.375621,0.6925,0.192167,686,1608,2294,Spring,Clear,365,1608,2294,3,1,1,311
367,2012-01-02,1,1,1,1,1,0,1,0.273043,0.252304,0.381304,0.329665,244,1707,1951,Spring,Clear,364,1707,1951,3,1,1,311
368,2012-01-03,1,1,1,0,2,1,1,0.15,0.126275,0.44125,0.365671,89,2147,2236,Spring,Clear,363,2147,2236,3,1,1,311
369,2012-01-04,1,1,1,0,3,1,2,0.1075,0.119337,0.414583,0.1847,95,2273,2368,Spring,Mist + Cloudy,362,2273,2368,3,1,1,311
370,2012-01-05,1,1,1,0,4,1,1,0.265833,0.278412,0.524167,0.129987,140,3132,3272,Spring,Clear,361,3132,3272,3,2,2,322
371,2012-01-06,1,1,1,0,5,1,1,0.334167,0.340267,0.542083,0.167908,307,3791,4098,Spring,Clear,360,3791,4098,3,3,2,332
372,2012-01-07,1,1,1,0,6,0,1,0.393333,0.390779,0.531667,0.174758,1070,3451,4521,Spring,Clear,359,3451,4521,3,2,2,322
373,2012-01-08,1,1,1,0,0,0,1,0.3375,0.340258,0.465,0.191542,599,2826,3425,Spring,Clear,358,2826,3425,3,2,2,322
374,2012-01-09,1,1,1,0,1,1,2,0.224167,0.247479,0.701667,0.0989,106,2270,2376,Spring,Mist + Cloudy,357,2270,2376,3,1,1,311
375,2012-01-10,1,1,1,0,2,1,1,0.308696,0.318826,0.646522,0.187552,173,3425,3598,Spring,Clear,356,3425,3598,3,2,2,322
376,2012-01-11,1,1,1,0,3,1,2,0.274167,0.282821,0.8475,0.131221,92,2085,2177,Spring,Mist + Cloudy,355,2085,2177,3,1,1,311
377,2012-01-12,1,1,1,0,4,1,2,0.3825,0.381938,0.802917,0.180967,269,3828,4097,Spring,Mist + Cloudy,354,3828,4097,3,3,2,332
378,2012-01-13,1,1,1,0,5,1,1,0.274167,0.249362,0.5075,0.378108,174,3040,3214,Spring,Clear,353,3040,3214,3,2,2,322
379,2012-01-14,1,1,1,0,6,0,1,0.18,0.183087,0.4575,0.187183,333,2160,2493,Spring,Clear,352,2160,2493,3,1,1,311
380,2012-01-15,1,1,1,0,0,0,1,0.166667,0.161625,0.419167,0.251258,284,2027,2311,Spring,Clear,351,2027,2311,3,1,1,311
381,2012-01-16,1,1,1,1,1,0,1,0.19,0.190663,0.5225,0.231358,217,2081,2298,Spring,Clear,350,2081,2298,3,1,1,311
382,2012-01-17,1,1,1,0,2,1,2,0.373043,0.364278,0.716087,0.34913,127,2808,2935,Spring,Mist + Cloudy,349,2808,2935,3,2,1,321
383,2012-01-18,1,1,1,0,3,1,1,0.303333,0.275254,0.443333,0.415429,109,3267,3376,Spring,Clear,348,3267,3376,3,2,2,322
384,2012-01-19,1,1,1,0,4,1,1,0.19,0.190038,0.4975,0.220158,130,3162,3292,Spring,Clear,347,3162,3292,3,2,2,322
385,2012-01-20,1,1,1,0,5,1,2,0.2175,0.220958,0.45,0.20275,115,3048,3163,Spring,Mist + Cloudy,346,3048,3163,3,2,2,322
386,2012-01-21,1,1,1,0,6,0,2,0.173333,0.174875,0.83125,0.222642,67,1234,1301,Spring,Mist + Cloudy,345,1234,1301,3,1,1,311
387,2012-01-22,1,1,1,0,0,0,2,0.1625,0.16225,0.79625,0.199638,196,1781,1977,Spring,Mist + Cloudy,344,1781,1977,3,1,1,311
388,2012-01-23,1,1,1,0,1,1,2,0.218333,0.243058,0.91125,0.110708,145,2287,2432,Spring,Mist + Cloudy,343,2287,2432,3,1,1,311
389,2012-01-24,1,1,1,0,2,1,1,0.3425,0.349108,0.835833,0.123767,439,3900,4339,Spring,Clear,342,3900,4339,3,3,2,332
390,2012-01-25,1,1,1,0,3,1,1,0.294167,0.294821,0.64375,0.161071,467,3803,4270,Spring,Clear,341,3803,4270,3,3,2,332
391,2012-01-26,1,1,1,0,4,1,2,0.341667,0.35605,0.769583,0.0733958,244,3831,4075,Spring,Mist + Cloudy,340,3831,4075,3,3,2,332
392,2012-01-27,1,1,1,0,5,1,2,0.425,0.415383,0.74125,0.342667,269,3187,3456,Spring,Mist + Cloudy,339,3187,3456,3,2,2,322
393,2012-01-28,1,1,1,0,6,0,1,0.315833,0.326379,0.543333,0.210829,775,3248,4023,Spring,Clear,338,3248,4023,3,2,2,322
394,2012-01-29,1,1,1,0,0,0,1,0.2825,0.272721,0.31125,0.24005,558,2685,3243,Spring,Clear,337,2685,3243,3,2,2,322
395,2012-01-30,1,1,1,0,1,1,1,0.269167,0.262625,0.400833,0.215792,126,3498,3624,Spring,Clear,336,3498,3624,3,2,2,322
396,2012-01-31,1,1,1,0,2,1,1,0.39,0.381317,0.416667,0.261817,324,4185,4509,Spring,Clear,335,4185,4509,3,3,2,332
397,2012-02-01,1,1,2,0,3,1,1,0.469167,0.466538,0.507917,0.189067,304,4275,4579,Spring,Clear,334,4275,4579,3,3,3,333
398,2012-02-02,1,1,2,0,4,1,2,0.399167,0.398971,0.672917,0.187187,190,3571,3761,Spring,Mist + Cloudy,333,3571,3761,3,2,2,322
399,2012-02-03,1,1,2,0,5,1,1,0.313333,0.309346,0.526667,0.178496,310,3841,4151,Spring,Clear,332,3841,4151,3,3,2,332
400,2012-02-04,1,1,2,0,6,0,2,0.264167,0.272725,0.779583,0.121896,384,2448,2832,Spring,Mist + Cloudy,331,2448,2832,3,1,1,311
401,2012-02-05,1,1,2,0,0,0,2,0.265833,0.264521,0.687917,0.175996,318,2629,2947,Spring,Mist + Cloudy,330,2629,2947,3,2,1,321
402,2012-02-06,1,1,2,0,1,1,1,0.282609,0.296426,0.622174,0.1538,206,3578,3784,Spring,Clear,329,3578,3784,3,2,2,322
403,2012-02-07,1,1,2,0,2,1,1,0.354167,0.361104,0.49625,0.147379,199,4176,4375,Spring,Clear,328,4176,4375,3,3,2,332
404,2012-02-08,1,1,2,0,3,1,2,0.256667,0.266421,0.722917,0.133721,109,2693,2802,Spring,Mist + Cloudy,327,2693,2802,3,2,1,321
405,2012-02-09,1,1,2,0,4,1,1,0.265,0.261988,0.562083,0.194037,163,3667,3830,Spring,Clear,326,3667,3830,3,3,2,332
406,2012-02-10,1,1,2,0,5,1,2,0.280833,0.293558,0.54,0.116929,227,3604,3831,Spring,Mist + Cloudy,325,3604,3831,3,2,2,322
407,2012-02-11,1,1,2,0,6,0,3,0.224167,0.210867,0.73125,0.289796,192,1977,2169,Spring,Light Snow/Rain,324,1977,2169,3,1,1,311
408,2012-02-12,1,1,2,0,0,0,1,0.1275,0.101658,0.464583,0.409212,73,1456,1529,Spring,Clear,323,1456,1529,3,1,1,311
409,2012-02-13,1,1,2,0,1,1,1,0.2225,0.227913,0.41125,0.167283,94,3328,3422,Spring,Clear,322,3328,3422,3,2,2,322
410,2012-02-14,1,1,2,0,2,1,2,0.319167,0.333946,0.50875,0.141179,135,3787,3922,Spring,Mist + Cloudy,321,3787,3922,3,3,2,332
411,2012-02-15,1,1,2,0,3,1,1,0.348333,0.351629,0.53125,0.1816,141,4028,4169,Spring,Clear,320,4028,4169,3,3,2,332
412,2012-02-16,1,1,2,0,4,1,2,0.316667,0.330162,0.752917,0.091425,74,2931,3005,Spring,Mist + Cloudy,319,2931,3005,3,2,1,321
413,2012-02-17,1,1,2,0,5,1,1,0.343333,0.351629,0.634583,0.205846,349,3805,4154,Spring,Clear,318,3805,4154,3,3,2,332
414,2012-02-18,1,1,2,0,6,0,1,0.346667,0.355425,0.534583,0.190929,1435,2883,4318,Spring,Clear,317,2883,4318,3,2,2,322
415,2012-02-19,1,1,2,0,0,0,2,0.28,0.265788,0.515833,0.253112,618,2071,2689,Spring,Mist + Cloudy,316,2071,2689,3,1,1,311
416,2012-02-20,1,1,2,1,1,0,1,0.28,0.273391,0.507826,0.229083,502,2627,3129,Spring,Clear,315,2627,3129,3,2,1,321
417,2012-02-21,1,1,2,0,2,1,1,0.287826,0.295113,0.594348,0.205717,163,3614,3777,Spring,Clear,314,3614,3777,3,2,2,322
418,2012-02-22,1,1,2,0,3,1,1,0.395833,0.392667,0.567917,0.234471,394,4379,4773,Spring,Clear,313,4379,4773,3,3,3,333
419,2012-02-23,1,1,2,0,4,1,1,0.454167,0.444446,0.554583,0.190913,516,4546,5062,Spring,Clear,312,4546,5062,3,3,3,333
420,2012-02-24,1,1,2,0,5,1,2,0.4075,0.410971,0.7375,0.237567,246,3241,3487,Spring,Mist + Cloudy,311,3241,3487,3,2,2,322
421,2012-02-25,1,1,2,0,6,0,1,0.290833,0.255675,0.395833,0.421642,317,2415,2732,Spring,Clear,310,2415,2732,3,1,1,311
422,2012-02-26,1,1,2,0,0,0,1,0.279167,0.268308,0.41,0.205229,515,2874,3389,Spring,Clear,309,2874,3389,3,2,2,322
423,2012-02-27,1,1,2,0,1,1,1,0.366667,0.357954,0.490833,0.268033,253,4069,4322,Spring,Clear,308,4069,4322,3,3,2,332
424,2012-02-28,1,1,2,0,2,1,1,0.359167,0.353525,0.395833,0.193417,229,4134,4363,Spring,Clear,307,4134,4363,3,3,2,332
425,2012-02-29,1,1,2,0,3,1,2,0.344348,0.34847,0.804783,0.179117,65,1769,1834,Spring,Mist + Cloudy,306,1769,1834,3,1,1,311
426,2012-03-01,1,1,3,0,4,1,1,0.485833,0.475371,0.615417,0.226987,325,4665,4990,Spring,Clear,305,4665,4990,3,3,3,333
427,2012-03-02,1,1,3,0,5,1,2,0.353333,0.359842,0.657083,0.144904,246,2948,3194,Spring,Mist + Cloudy,304,2948,3194,3,2,2,322
428,2012-03-03,1,1,3,0,6,0,2,0.414167,0.413492,0.62125,0.161079,956,3110,4066,Spring,Mist + Cloudy,303,3110,4066,3,2,2,322
429,2012-03-04,1,1,3,0,0,0,1,0.325833,0.303021,0.403333,0.334571,710,2713,3423,Spring,Clear,302,2713,3423,3,2,2,322
430,2012-03-05,1,1,3,0,1,1,1,0.243333,0.241171,0.50625,0.228858,203,3130,3333,Spring,Clear,301,3130,3333,3,2,2,322
431,2012-03-06,1,1,3,0,2,1,1,0.258333,0.255042,0.456667,0.200875,221,3735,3956,Spring,Clear,300,3735,3956,3,3,2,332
432,2012-03-07,1,1,3,0,3,1,1,0.404167,0.3851,0.513333,0.345779,432,4484,4916,Spring,Clear,299,4484,4916,3,3,3,333
433,2012-03-08,1,1,3,0,4,1,1,0.5275,0.524604,0.5675,0.441563,486,4896,5382,Spring,Clear,298,4896,5382,3,4,3,343
434,2012-03-09,1,1,3,0,5,1,2,0.410833,0.397083,0.407083,0.4148,447,4122,4569,Spring,Mist + Cloudy,297,4122,4569,3,3,3,333
435,2012-03-10,1,1,3,0,6,0,1,0.2875,0.277767,0.350417,0.22575,968,3150,4118,Spring,Clear,296,3150,4118,3,2,2,322
436,2012-03-11,1,1,3,0,0,0,1,0.361739,0.35967,0.476957,0.222587,1658,3253,4911,Spring,Clear,295,3253,4911,3,2,3,323
437,2012-03-12,1,1,3,0,1,1,1,0.466667,0.459592,0.489167,0.207713,838,4460,5298,Spring,Clear,294,4460,5298,3,3,3,333
438,2012-03-13,1,1,3,0,2,1,1,0.565,0.542929,0.6175,0.23695,762,5085,5847,Spring,Clear,293,5085,5847,3,4,3,343
439,2012-03-14,1,1,3,0,3,1,1,0.5725,0.548617,0.507083,0.115062,997,5315,6312,Spring,Clear,292,5315,6312,3,4,4,344
440,2012-03-15,1,1,3,0,4,1,1,0.5575,0.532825,0.579583,0.149883,1005,5187,6192,Spring,Clear,291,5187,6192,3,4,4,344
441,2012-03-16,1,1,3,0,5,1,2,0.435833,0.436229,0.842083,0.113192,548,3830,4378,Spring,Mist + Cloudy,290,3830,4378,3,3,2,332
442,2012-03-17,1,1,3,0,6,0,2,0.514167,0.505046,0.755833,0.110704,3155,4681,7836,Spring,Mist + Cloudy,289,4681,7836,3,3,4,334
443,2012-03-18,1,1,3,0,0,0,2,0.4725,0.464,0.81,0.126883,2207,3685,5892,Spring,Mist + Cloudy,288,3685,5892,3,3,3,333
444,2012-03-19,1,1,3,0,1,1,1,0.545,0.532821,0.72875,0.162317,982,5171,6153,Spring,Clear,287,5171,6153,3,4,4,344
445,2012-03-20,1,1,3,0,2,1,1,0.560833,0.538533,0.807917,0.121271,1051,5042,6093,Spring,Clear,286,5042,6093,3,4,4,344
446,2012-03-21,2,1,3,0,3,1,2,0.531667,0.513258,0.82125,0.0895583,1122,5108,6230,Summer,Mist + Cloudy,285,5108,6230,3,4,4,344
447,2012-03-22,2,1,3,0,4,1,1,0.554167,0.531567,0.83125,0.117562,1334,5537,6871,Summer,Clear,284,5537,6871,3,4,4,344
448,2012-03-23,2,1,3,0,5,1,2,0.601667,0.570067,0.694167,0.1163,2469,5893,8362,Summer,Mist + Cloudy,283,5893,8362,3,4,4,344
449,2012-03-24,2,1,3,0,6,0,2,0.5025,0.486733,0.885417,0.192783,1033,2339,3372,Summer,Mist + Cloudy,282,2339,3372,3,1,2,312
450,2012-03-25,2,1,3,0,0,0,2,0.4375,0.437488,0.880833,0.220775,1532,3464,4996,Summer,Mist + Cloudy,281,3464,4996,3,2,3,323
451,2012-03-26,2,1,3,0,1,1,1,0.445833,0.43875,0.477917,0.386821,795,4763,5558,Summer,Clear,280,4763,5558,3,3,3,333
452,2012-03-27,2,1,3,0,2,1,1,0.323333,0.315654,0.29,0.187192,531,4571,5102,Summer,Clear,279,4571,5102,3,3,3,333
453,2012-03-28,2,1,3,0,3,1,1,0.484167,0.47095,0.48125,0.291671,674,5024,5698,Summer,Clear,278,5024,5698,3,4,3,343
454,2012-03-29,2,1,3,0,4,1,1,0.494167,0.482304,0.439167,0.31965,834,5299,6133,Summer,Clear,277,5299,6133,3,4,4,344
455,2012-03-30,2,1,3,0,5,1,2,0.37,0.375621,0.580833,0.138067,796,4663,5459,Summer,Mist + Cloudy,276,4663,5459,3,3,3,333
456,2012-03-31,2,1,3,0,6,0,2,0.424167,0.421708,0.738333,0.250617,2301,3934,6235,Summer,Mist + Cloudy,275,3934,6235,3,3,4,334
457,2012-04-01,2,1,4,0,0,0,2,0.425833,0.417287,0.67625,0.172267,2347,3694,6041,Summer,Mist + Cloudy,274,3694,6041,3,3,4,334
458,2012-04-02,2,1,4,0,1,1,1,0.433913,0.427513,0.504348,0.312139,1208,4728,5936,Summer,Clear,273,4728,5936,3,3,3,333
459,2012-04-03,2,1,4,0,2,1,1,0.466667,0.461483,0.396667,0.100133,1348,5424,6772,Summer,Clear,272,5424,6772,3,4,4,344
460,2012-04-04,2,1,4,0,3,1,1,0.541667,0.53345,0.469583,0.180975,1058,5378,6436,Summer,Clear,271,5378,6436,3,4,4,344
461,2012-04-05,2,1,4,0,4,1,1,0.435,0.431163,0.374167,0.219529,1192,5265,6457,Summer,Clear,270,5265,6457,3,4,4,344
462,2012-04-06,2,1,4,0,5,1,1,0.403333,0.390767,0.377083,0.300388,1807,4653,6460,Summer,Clear,269,4653,6460,3,3,4,334
463,2012-04-07,2,1,4,0,6,0,1,0.4375,0.426129,0.254167,0.274871,3252,3605,6857,Summer,Clear,268,3605,6857,3,2,4,324
464,2012-04-08,2,1,4,0,0,0,1,0.5,0.492425,0.275833,0.232596,2230,2939,5169,Summer,Clear,267,2939,5169,3,2,3,323
465,2012-04-09,2,1,4,0,1,1,1,0.489167,0.476638,0.3175,0.358196,905,4680,5585,Summer,Clear,266,4680,5585,3,3,3,333
466,2012-04-10,2,1,4,0,2,1,1,0.446667,0.436233,0.435,0.249375,819,5099,5918,Summer,Clear,265,5099,5918,3,4,3,343
467,2012-04-11,2,1,4,0,3,1,1,0.348696,0.337274,0.469565,0.295274,482,4380,4862,Summer,Clear,264,4380,4862,3,3,3,333
468,2012-04-12,2,1,4,0,4,1,1,0.3975,0.387604,0.46625,0.290429,663,4746,5409,Summer,Clear,263,4746,5409,3,3,3,333
469,2012-04-13,2,1,4,0,5,1,1,0.4425,0.431808,0.408333,0.155471,1252,5146,6398,Summer,Clear,262,5146,6398,3,4,4,344
470,2012-04-14,2,1,4,0,6,0,1,0.495,0.487996,0.502917,0.190917,2795,4665,7460,Summer,Clear,261,4665,7460,3,3,4,334
471,2012-04-15,2,1,4,0,0,0,1,0.606667,0.573875,0.507917,0.225129,2846,4286,7132,Summer,Clear,260,4286,7132,3,3,4,334
472,2012-04-16,2,1,4,1,1,0,1,0.664167,0.614925,0.561667,0.284829,1198,5172,6370,Summer,Clear,259,5172,6370,3,4,4,344
473,2012-04-17,2,1,4,0,2,1,1,0.608333,0.598487,0.390417,0.273629,989,5702,6691,Summer,Clear,258,5702,6691,3,4,4,344
474,2012-04-18,2,1,4,0,3,1,2,0.463333,0.457038,0.569167,0.167912,347,4020,4367,Summer,Mist + Cloudy,257,4020,4367,3,3,2,332
475,2012-04-19,2,1,4,0,4,1,1,0.498333,0.493046,0.6125,0.0659292,846,5719,6565,Summer,Clear,256,5719,6565,3,4,4,344
476,2012-04-20,2,1,4,0,5,1,1,0.526667,0.515775,0.694583,0.149871,1340,5950,7290,Summer,Clear,255,5950,7290,3,4,4,344
477,2012-04-21,2,1,4,0,6,0,1,0.57,0.542921,0.682917,0.283587,2541,4083,6624,Summer,Clear,254,4083,6624,3,3,4,334
478,2012-04-22,2,1,4,0,0,0,3,0.396667,0.389504,0.835417,0.344546,120,907,1027,Summer,Light Snow/Rain,253,907,1027,3,1,1,311
479,2012-04-23,2,1,4,0,1,1,2,0.321667,0.301125,0.766667,0.303496,195,3019,3214,Summer,Mist + Cloudy,252,3019,3214,3,2,2,322
480,2012-04-24,2,1,4,0,2,1,1,0.413333,0.405283,0.454167,0.249383,518,5115,5633,Summer,Clear,251,5115,5633,3,4,3,343
481,2012-04-25,2,1,4,0,3,1,1,0.476667,0.470317,0.427917,0.118792,655,5541,6196,Summer,Clear,250,5541,6196,3,4,4,344
482,2012-04-26,2,1,4,0,4,1,2,0.498333,0.483583,0.756667,0.176625,475,4551,5026,Summer,Mist + Cloudy,249,4551,5026,3,3,3,333
483,2012-04-27,2,1,4,0,5,1,1,0.4575,0.452637,0.400833,0.347633,1014,5219,6233,Summer,Clear,248,5219,6233,3,4,4,344
484,2012-04-28,2,1,4,0,6,0,2,0.376667,0.377504,0.489583,0.129975,1120,3100,4220,Summer,Mist + Cloudy,247,3100,4220,3,2,2,322
485,2012-04-29,2,1,4,0,0,0,1,0.458333,0.450121,0.587083,0.116908,2229,4075,6304,Summer,Clear,246,4075,6304,3,3,4,334
486,2012-04-30,2,1,4,0,1,1,2,0.464167,0.457696,0.57,0.171638,665,4907,5572,Summer,Mist + Cloudy,245,4907,5572,3,4,3,343
487,2012-05-01,2,1,5,0,2,1,2,0.613333,0.577021,0.659583,0.156096,653,5087,5740,Summer,Mist + Cloudy,244,5087,5740,3,4,3,343
488,2012-05-02,2,1,5,0,3,1,1,0.564167,0.537896,0.797083,0.138058,667,5502,6169,Summer,Clear,243,5502,6169,3,4,4,344
489,2012-05-03,2,1,5,0,4,1,2,0.56,0.537242,0.768333,0.133696,764,5657,6421,Summer,Mist + Cloudy,242,5657,6421,3,4,4,344
490,2012-05-04,2,1,5,0,5,1,1,0.6275,0.590917,0.735417,0.162938,1069,5227,6296,Summer,Clear,241,5227,6296,3,4,4,344
491,2012-05-05,2,1,5,0,6,0,2,0.621667,0.584608,0.756667,0.152992,2496,4387,6883,Summer,Mist + Cloudy,240,4387,6883,3,3,4,334
492,2012-05-06,2,1,5,0,0,0,2,0.5625,0.546737,0.74,0.149879,2135,4224,6359,Summer,Mist + Cloudy,239,4224,6359,3,3,4,334
493,2012-05-07,2,1,5,0,1,1,2,0.5375,0.527142,0.664167,0.230721,1008,5265,6273,Summer,Mist + Cloudy,238,5265,6273,3,4,4,344
494,2012-05-08,2,1,5,0,2,1,2,0.581667,0.557471,0.685833,0.296029,738,4990,5728,Summer,Mist + Cloudy,237,4990,5728,3,4,3,343
495,2012-05-09,2,1,5,0,3,1,2,0.575,0.553025,0.744167,0.216412,620,4097,4717,Summer,Mist + Cloudy,236,4097,4717,3,3,3,333
496,2012-05-10,2,1,5,0,4,1,1,0.505833,0.491783,0.552083,0.314063,1026,5546,6572,Summer,Clear,235,5546,6572,3,4,4,344
497,2012-05-11,2,1,5,0,5,1,1,0.533333,0.520833,0.360417,0.236937,1319,5711,7030,Summer,Clear,234,5711,7030,3,4,4,344
498,2012-05-12,2,1,5,0,6,0,1,0.564167,0.544817,0.480417,0.123133,2622,4807,7429,Summer,Clear,233,4807,7429,3,4,4,344
499,2012-05-13,2,1,5,0,0,0,1,0.6125,0.585238,0.57625,0.225117,2172,3946,6118,Summer,Clear,232,3946,6118,3,3,4,334
500,2012-05-14,2,1,5,0,1,1,2,0.573333,0.5499,0.789583,0.212692,342,2501,2843,Summer,Mist + Cloudy,231,2501,2843,3,2,1,321
501,2012-05-15,2,1,5,0,2,1,2,0.611667,0.576404,0.794583,0.147392,625,4490,5115,Summer,Mist + Cloudy,230,4490,5115,3,3,3,333
502,2012-05-16,2,1,5,0,3,1,1,0.636667,0.595975,0.697917,0.122512,991,6433,7424,Summer,Clear,229,6433,7424,3,4,4,344
503,2012-05-17,2,1,5,0,4,1,1,0.593333,0.572613,0.52,0.229475,1242,6142,7384,Summer,Clear,228,6142,7384,3,4,4,344
504,2012-05-18,2,1,5,0,5,1,1,0.564167,0.551121,0.523333,0.136817,1521,6118,7639,Summer,Clear,227,6118,7639,3,4,4,344
505,2012-05-19,2,1,5,0,6,0,1,0.6,0.566908,0.45625,0.083975,3410,4884,8294,Summer,Clear,226,4884,8294,3,4,4,344
506,2012-05-20,2,1,5,0,0,0,1,0.620833,0.583967,0.530417,0.254367,2704,4425,7129,Summer,Clear,225,4425,7129,3,3,4,334
507,2012-05-21,2,1,5,0,1,1,2,0.598333,0.565667,0.81125,0.233204,630,3729,4359,Summer,Mist + Cloudy,224,3729,4359,3,3,2,332
508,2012-05-22,2,1,5,0,2,1,2,0.615,0.580825,0.765833,0.118167,819,5254,6073,Summer,Mist + Cloudy,223,5254,6073,3,4,4,344
509,2012-05-23,2,1,5,0,3,1,2,0.621667,0.584612,0.774583,0.102,766,4494,5260,Summer,Mist + Cloudy,222,4494,5260,3,3,3,333
510,2012-05-24,2,1,5,0,4,1,1,0.655,0.6067,0.716667,0.172896,1059,5711,6770,Summer,Clear,221,5711,6770,3,4,4,344
511,2012-05-25,2,1,5,0,5,1,1,0.68,0.627529,0.747083,0.14055,1417,5317,6734,Summer,Clear,220,5317,6734,3,4,4,344
512,2012-05-26,2,1,5,0,6,0,1,0.6925,0.642696,0.7325,0.198992,2855,3681,6536,Summer,Clear,219,3681,6536,3,3,4,334
513,2012-05-27,2,1,5,0,0,0,1,0.69,0.641425,0.697083,0.215171,3283,3308,6591,Summer,Clear,218,3308,6591,3,2,4,324
514,2012-05-28,2,1,5,1,1,0,1,0.7125,0.6793,0.67625,0.196521,2557,3486,6043,Summer,Clear,217,3486,6043,3,2,4,324
515,2012-05-29,2,1,5,0,2,1,1,0.7225,0.672992,0.684583,0.2954,880,4863,5743,Summer,Clear,216,4863,5743,3,4,3,343
516,2012-05-30,2,1,5,0,3,1,2,0.656667,0.611129,0.67,0.134329,745,6110,6855,Summer,Mist + Cloudy,215,6110,6855,3,4,4,344
517,2012-05-31,2,1,5,0,4,1,1,0.68,0.631329,0.492917,0.195279,1100,6238,7338,Summer,Clear,214,6238,7338,3,4,4,344
518,2012-06-01,2,1,6,0,5,1,2,0.654167,0.607962,0.755417,0.237563,533,3594,4127,Summer,Mist + Cloudy,213,3594,4127,3,2,2,322
519,2012-06-02,2,1,6,0,6,0,1,0.583333,0.566288,0.549167,0.186562,2795,5325,8120,Summer,Clear,212,5325,8120,3,4,4,344
520,2012-06-03,2,1,6,0,0,0,1,0.6025,0.575133,0.493333,0.184087,2494,5147,7641,Summer,Clear,211,5147,7641,3,4,4,344
521,2012-06-04,2,1,6,0,1,1,1,0.5975,0.578283,0.487083,0.284833,1071,5927,6998,Summer,Clear,210,5927,6998,3,4,4,344
522,2012-06-05,2,1,6,0,2,1,2,0.540833,0.525892,0.613333,0.209575,968,6033,7001,Summer,Mist + Cloudy,209,6033,7001,3,4,4,344
523,2012-06-06,2,1,6,0,3,1,1,0.554167,0.542292,0.61125,0.077125,1027,6028,7055,Summer,Clear,208,6028,7055,3,4,4,344
524,2012-06-07,2,1,6,0,4,1,1,0.6025,0.569442,0.567083,0.15735,1038,6456,7494,Summer,Clear,207,6456,7494,3,4,4,344
525,2012-06-08,2,1,6,0,5,1,1,0.649167,0.597862,0.467917,0.175383,1488,6248,7736,Summer,Clear,206,6248,7736,3,4,4,344
526,2012-06-09,2,1,6,0,6,0,1,0.710833,0.648367,0.437083,0.144287,2708,4790,7498,Summer,Clear,205,4790,7498,3,4,4,344
527,2012-06-10,2,1,6,0,0,0,1,0.726667,0.663517,0.538333,0.133721,2224,4374,6598,Summer,Clear,204,4374,6598,3,3,4,334
528,2012-06-11,2,1,6,0,1,1,2,0.720833,0.659721,0.587917,0.207713,1017,5647,6664,Summer,Mist + Cloudy,203,5647,6664,3,4,4,344
529,2012-06-12,2,1,6,0,2,1,2,0.653333,0.597875,0.833333,0.214546,477,4495,4972,Summer,Mist + Cloudy,202,4495,4972,3,3,3,333
530,2012-06-13,2,1,6,0,3,1,1,0.655833,0.611117,0.582083,0.343279,1173,6248,7421,Summer,Clear,201,6248,7421,3,4,4,344
531,2012-06-14,2,1,6,0,4,1,1,0.648333,0.624383,0.569583,0.253733,1180,6183,7363,Summer,Clear,200,6183,7363,3,4,4,344
532,2012-06-15,2,1,6,0,5,1,1,0.639167,0.599754,0.589583,0.176617,1563,6102,7665,Summer,Clear,199,6102,7665,3,4,4,344
533,2012-06-16,2,1,6,0,6,0,1,0.631667,0.594708,0.504167,0.166667,2963,4739,7702,Summer,Clear,198,4739,7702,3,3,4,334
534,2012-06-17,2,1,6,0,0,0,1,0.5925,0.571975,0.59875,0.144904,2634,4344,6978,Summer,Clear,197,4344,6978,3,3,4,334
535,2012-06-18,2,1,6,0,1,1,2,0.568333,0.544842,0.777917,0.174746,653,4446,5099,Summer,Mist + Cloudy,196,4446,5099,3,3,3,333
536,2012-06-19,2,1,6,0,2,1,1,0.688333,0.654692,0.69,0.148017,968,5857,6825,Summer,Clear,195,5857,6825,3,4,4,344
537,2012-06-20,2,1,6,0,3,1,1,0.7825,0.720975,0.592083,0.113812,872,5339,6211,Summer,Clear,194,5339,6211,3,4,4,344
538,2012-06-21,3,1,6,0,4,1,1,0.805833,0.752542,0.567917,0.118787,778,5127,5905,Fall,Clear,193,5127,5905,3,4,3,343
539,2012-06-22,3,1,6,0,5,1,1,0.7775,0.724121,0.57375,0.182842,964,4859,5823,Fall,Clear,192,4859,5823,3,4,3,343
540,2012-06-23,3,1,6,0,6,0,1,0.731667,0.652792,0.534583,0.179721,2657,4801,7458,Fall,Clear,191,4801,7458,3,4,4,344
541,2012-06-24,3,1,6,0,0,0,1,0.743333,0.674254,0.479167,0.145525,2551,4340,6891,Fall,Clear,190,4340,6891,3,3,4,334
542,2012-06-25,3,1,6,0,1,1,1,0.715833,0.654042,0.504167,0.300383,1139,5640,6779,Fall,Clear,189,5640,6779,3,4,4,344
543,2012-06-26,3,1,6,0,2,1,1,0.630833,0.594704,0.373333,0.347642,1077,6365,7442,Fall,Clear,188,6365,7442,3,4,4,344
544,2012-06-27,3,1,6,0,3,1,1,0.6975,0.640792,0.36,0.271775,1077,6258,7335,Fall,Clear,187,6258,7335,3,4,4,344
545,2012-06-28,3,1,6,0,4,1,1,0.749167,0.675512,0.4225,0.17165,921,5958,6879,Fall,Clear,186,5958,6879,3,4,4,344
546,2012-06-29,3,1,6,0,5,1,1,0.834167,0.786613,0.48875,0.165417,829,4634,5463,Fall,Clear,185,4634,5463,3,3,3,333
547,2012-06-30,3,1,6,0,6,0,1,0.765,0.687508,0.60125,0.161071,1455,4232,5687,Fall,Clear,184,4232,5687,3,3,3,333
548,2012-07-01,3,1,7,0,0,0,1,0.815833,0.750629,0.51875,0.168529,1421,4110,5531,Fall,Clear,183,4110,5531,3,3,3,333
549,2012-07-02,3,1,7,0,1,1,1,0.781667,0.702038,0.447083,0.195267,904,5323,6227,Fall,Clear,182,5323,6227,4,4,4,444
550,2012-07-03,3,1,7,0,2,1,1,0.780833,0.70265,0.492083,0.126237,1052,5608,6660,Fall,Clear,181,5608,6660,4,4,4,444
551,2012-07-04,3,1,7,1,3,0,1,0.789167,0.732337,0.53875,0.13495,2562,4841,7403,Fall,Clear,180,4841,7403,4,4,4,444
552,2012-07-05,3,1,7,0,4,1,1,0.8275,0.761367,0.457917,0.194029,1405,4836,6241,Fall,Clear,179,4836,6241,4,4,4,444
553,2012-07-06,3,1,7,0,5,1,1,0.828333,0.752533,0.450833,0.146142,1366,4841,6207,Fall,Clear,178,4841,6207,4,4,4,444
554,2012-07-07,3,1,7,0,6,0,1,0.861667,0.804913,0.492083,0.163554,1448,3392,4840,Fall,Clear,177,3392,4840,4,2,3,423
555,2012-07-08,3,1,7,0,0,0,1,0.8225,0.790396,0.57375,0.125629,1203,3469,4672,Fall,Clear,176,3469,4672,4,2,3,423
556,2012-07-09,3,1,7,0,1,1,2,0.710833,0.654054,0.683333,0.180975,998,5571,6569,Fall,Mist + Cloudy,175,5571,6569,4,4,4,444
557,2012-07-10,3,1,7,0,2,1,2,0.720833,0.664796,0.6675,0.151737,954,5336,6290,Fall,Mist + Cloudy,174,5336,6290,4,4,4,444
558,2012-07-11,3,1,7,0,3,1,1,0.716667,0.650271,0.633333,0.151733,975,6289,7264,Fall,Clear,173,6289,7264,4,4,4,444
559,2012-07-12,3,1,7,0,4,1,1,0.715833,0.654683,0.529583,0.146775,1032,6414,7446,Fall,Clear,172,6414,7446,4,4,4,444
560,2012-07-13,3,1,7,0,5,1,2,0.731667,0.667933,0.485833,0.08085,1511,5988,7499,Fall,Mist + Cloudy,171,5988,7499,4,4,4,444
561,2012-07-14,3,1,7,0,6,0,2,0.703333,0.666042,0.699167,0.143679,2355,4614,6969,Fall,Mist + Cloudy,170,4614,6969,4,3,4,434
562,2012-07-15,3,1,7,0,0,0,1,0.745833,0.705196,0.717917,0.166667,1920,4111,6031,Fall,Clear,169,4111,6031,4,3,4,434
563,2012-07-16,3,1,7,0,1,1,1,0.763333,0.724125,0.645,0.164187,1088,5742,6830,Fall,Clear,168,5742,6830,4,4,4,444
564,2012-07-17,3,1,7,0,2,1,1,0.818333,0.755683,0.505833,0.114429,921,5865,6786,Fall,Clear,167,5865,6786,4,4,4,444
565,2012-07-18,3,1,7,0,3,1,1,0.793333,0.745583,0.577083,0.137442,799,4914,5713,Fall,Clear,166,4914,5713,4,4,3,443
566,2012-07-19,3,1,7,0,4,1,1,0.77,0.714642,0.600417,0.165429,888,5703,6591,Fall,Clear,165,5703,6591,4,4,4,444
567,2012-07-20,3,1,7,0,5,1,2,0.665833,0.613025,0.844167,0.208967,747,5123,5870,Fall,Mist + Cloudy,164,5123,5870,4,4,3,443
568,2012-07-21,3,1,7,0,6,0,3,0.595833,0.549912,0.865417,0.2133,1264,3195,4459,Fall,Light Snow/Rain,163,3195,4459,4,2,2,422
569,2012-07-22,3,1,7,0,0,0,2,0.6675,0.623125,0.7625,0.0939208,2544,4866,7410,Fall,Mist + Cloudy,162,4866,7410,4,4,4,444
570,2012-07-23,3,1,7,0,1,1,1,0.741667,0.690017,0.694167,0.138683,1135,5831,6966,Fall,Clear,161,5831,6966,4,4,4,444
571,2012-07-24,3,1,7,0,2,1,1,0.750833,0.70645,0.655,0.211454,1140,6452,7592,Fall,Clear,160,6452,7592,4,4,4,444
572,2012-07-25,3,1,7,0,3,1,1,0.724167,0.654054,0.45,0.1648,1383,6790,8173,Fall,Clear,159,6790,8173,4,4,4,444
573,2012-07-26,3,1,7,0,4,1,1,0.776667,0.739263,0.596667,0.284813,1036,5825,6861,Fall,Clear,158,5825,6861,4,4,4,444
574,2012-07-27,3,1,7,0,5,1,1,0.781667,0.734217,0.594583,0.152992,1259,5645,6904,Fall,Clear,157,5645,6904,4,4,4,444
575,2012-07-28,3,1,7,0,6,0,1,0.755833,0.697604,0.613333,0.15735,2234,4451,6685,Fall,Clear,156,4451,6685,4,3,4,434
576,2012-07-29,3,1,7,0,0,0,1,0.721667,0.667933,0.62375,0.170396,2153,4444,6597,Fall,Clear,155,4444,6597,4,3,4,434
577,2012-07-30,3,1,7,0,1,1,1,0.730833,0.684987,0.66875,0.153617,1040,6065,7105,Fall,Clear,154,6065,7105,4,4,4,444
578,2012-07-31,3,1,7,0,2,1,1,0.713333,0.662896,0.704167,0.165425,968,6248,7216,Fall,Clear,153,6248,7216,4,4,4,444
579,2012-08-01,3,1,8,0,3,1,1,0.7175,0.667308,0.6775,0.141179,1074,6506,7580,Fall,Clear,152,6506,7580,4,4,4,444
580,2012-08-02,3,1,8,0,4,1,1,0.7525,0.707088,0.659583,0.129354,983,6278,7261,Fall,Clear,151,6278,7261,4,4,4,444
581,2012-08-03,3,1,8,0,5,1,2,0.765833,0.722867,0.6425,0.215792,1328,5847,7175,Fall,Mist + Cloudy,150,5847,7175,4,4,4,444
582,2012-08-04,3,1,8,0,6,0,1,0.793333,0.751267,0.613333,0.257458,2345,4479,6824,Fall,Clear,149,4479,6824,4,3,4,434
583,2012-08-05,3,1,8,0,0,0,1,0.769167,0.731079,0.6525,0.290421,1707,3757,5464,Fall,Clear,148,3757,5464,4,3,3,433
584,2012-08-06,3,1,8,0,1,1,2,0.7525,0.710246,0.654167,0.129354,1233,5780,7013,Fall,Mist + Cloudy,147,5780,7013,4,4,4,444
585,2012-08-07,3,1,8,0,2,1,2,0.735833,0.697621,0.70375,0.116908,1278,5995,7273,Fall,Mist + Cloudy,146,5995,7273,4,4,4,444
586,2012-08-08,3,1,8,0,3,1,2,0.75,0.707717,0.672917,0.1107,1263,6271,7534,Fall,Mist + Cloudy,145,6271,7534,4,4,4,444
587,2012-08-09,3,1,8,0,4,1,1,0.755833,0.699508,0.620417,0.1561,1196,6090,7286,Fall,Clear,144,6090,7286,4,4,4,444
588,2012-08-10,3,1,8,0,5,1,2,0.715833,0.667942,0.715833,0.238813,1065,4721,5786,Fall,Mist + Cloudy,143,4721,5786,4,3,3,433
589,2012-08-11,3,1,8,0,6,0,2,0.6925,0.638267,0.732917,0.206479,2247,4052,6299,Fall,Mist + Cloudy,142,4052,6299,4,3,4,434
590,2012-08-12,3,1,8,0,0,0,1,0.700833,0.644579,0.530417,0.122512,2182,4362,6544,Fall,Clear,141,4362,6544,4,3,4,434
591,2012-08-13,3,1,8,0,1,1,1,0.720833,0.662254,0.545417,0.136212,1207,5676,6883,Fall,Clear,140,5676,6883,4,4,4,444
592,2012-08-14,3,1,8,0,2,1,1,0.726667,0.676779,0.686667,0.169158,1128,5656,6784,Fall,Clear,139,5656,6784,4,4,4,444
593,2012-08-15,3,1,8,0,3,1,1,0.706667,0.654037,0.619583,0.169771,1198,6149,7347,Fall,Clear,138,6149,7347,4,4,4,444
594,2012-08-16,3,1,8,0,4,1,1,0.719167,0.654688,0.519167,0.141796,1338,6267,7605,Fall,Clear,137,6267,7605,4,4,4,444
595,2012-08-17,3,1,8,0,5,1,1,0.723333,0.2424,0.570833,0.231354,1483,5665,7148,Fall,Clear,136,5665,7148,4,4,4,444
596,2012-08-18,3,1,8,0,6,0,1,0.678333,0.618071,0.603333,0.177867,2827,5038,7865,Fall,Clear,135,5038,7865,4,4,4,444
597,2012-08-19,3,1,8,0,0,0,2,0.635833,0.603554,0.711667,0.08645,1208,3341,4549,Fall,Mist + Cloudy,134,3341,4549,4,2,3,423
598,2012-08-20,3,1,8,0,1,1,2,0.635833,0.595967,0.734167,0.129979,1026,5504,6530,Fall,Mist + Cloudy,133,5504,6530,4,4,4,444
599,2012-08-21,3,1,8,0,2,1,1,0.649167,0.601025,0.67375,0.0727708,1081,5925,7006,Fall,Clear,132,5925,7006,4,4,4,444
600,2012-08-22,3,1,8,0,3,1,1,0.6675,0.621854,0.677083,0.0702833,1094,6281,7375,Fall,Clear,131,6281,7375,4,4,4,444
601,2012-08-23,3,1,8,0,4,1,1,0.695833,0.637008,0.635833,0.0845958,1363,6402,7765,Fall,Clear,130,6402,7765,4,4,4,444
602,2012-08-24,3,1,8,0,5,1,2,0.7025,0.6471,0.615,0.0721458,1325,6257,7582,Fall,Mist + Cloudy,129,6257,7582,4,4,4,444
603,2012-08-25,3,1,8,0,6,0,2,0.661667,0.618696,0.712917,0.244408,1829,4224,6053,Fall,Mist + Cloudy,128,4224,6053,4,3,4,434
604,2012-08-26,3,1,8,0,0,0,2,0.653333,0.595996,0.845833,0.228858,1483,3772,5255,Fall,Mist + Cloudy,127,3772,5255,4,3,3,433
605,2012-08-27,3,1,8,0,1,1,1,0.703333,0.654688,0.730417,0.128733,989,5928,6917,Fall,Clear,126,5928,6917,4,4,4,444
606,2012-08-28,3,1,8,0,2,1,1,0.728333,0.66605,0.62,0.190925,935,6105,7040,Fall,Clear,125,6105,7040,4,4,4,444
607,2012-08-29,3,1,8,0,3,1,1,0.685,0.635733,0.552083,0.112562,1177,6520,7697,Fall,Clear,124,6520,7697,4,4,4,444
608,2012-08-30,3,1,8,0,4,1,1,0.706667,0.652779,0.590417,0.0771167,1172,6541,7713,Fall,Clear,123,6541,7713,4,4,4,444
609,2012-08-31,3,1,8,0,5,1,1,0.764167,0.6894,0.5875,0.168533,1433,5917,7350,Fall,Clear,122,5917,7350,4,4,4,444
610,2012-09-01,3,1,9,0,6,0,2,0.753333,0.702654,0.638333,0.113187,2352,3788,6140,Fall,Mist + Cloudy,121,3788,6140,4,3,4,434
611,2012-09-02,3,1,9,0,0,0,2,0.696667,0.649,0.815,0.0640708,2613,3197,5810,Fall,Mist + Cloudy,120,3197,5810,4,2,3,423
612,2012-09-03,3,1,9,1,1,0,1,0.7075,0.661629,0.790833,0.151121,1965,4069,6034,Fall,Clear,119,4069,6034,4,3,4,434
613,2012-09-04,3,1,9,0,2,1,1,0.725833,0.686888,0.755,0.236321,867,5997,6864,Fall,Clear,118,5997,6864,4,4,4,444
614,2012-09-05,3,1,9,0,3,1,1,0.736667,0.708983,0.74125,0.187808,832,6280,7112,Fall,Clear,117,6280,7112,4,4,4,444
615,2012-09-06,3,1,9,0,4,1,2,0.696667,0.655329,0.810417,0.142421,611,5592,6203,Fall,Mist + Cloudy,116,5592,6203,4,4,4,444
616,2012-09-07,3,1,9,0,5,1,1,0.703333,0.657204,0.73625,0.171646,1045,6459,7504,Fall,Clear,115,6459,7504,4,4,4,444
617,2012-09-08,3,1,9,0,6,0,2,0.659167,0.611121,0.799167,0.281104,1557,4419,5976,Fall,Mist + Cloudy,114,4419,5976,4,3,4,434
618,2012-09-09,3,1,9,0,0,0,1,0.61,0.578925,0.5475,0.224496,2570,5657,8227,Fall,Clear,113,5657,8227,4,4,4,444
619,2012-09-10,3,1,9,0,1,1,1,0.583333,0.565654,0.50375,0.258713,1118,6407,7525,Fall,Clear,112,6407,7525,4,4,4,444
620,2012-09-11,3,1,9,0,2,1,1,0.5775,0.554292,0.52,0.0920542,1070,6697,7767,Fall,Clear,111,6697,7767,4,4,4,444
621,2012-09-12,3,1,9,0,3,1,1,0.599167,0.570075,0.577083,0.131846,1050,6820,7870,Fall,Clear,110,6820,7870,4,4,4,444
622,2012-09-13,3,1,9,0,4,1,1,0.6125,0.579558,0.637083,0.0827208,1054,6750,7804,Fall,Clear,109,6750,7804,4,4,4,444
623,2012-09-14,3,1,9,0,5,1,1,0.633333,0.594083,0.6725,0.103863,1379,6630,8009,Fall,Clear,108,6630,8009,4,4,4,444
624,2012-09-15,3,1,9,0,6,0,1,0.608333,0.585867,0.501667,0.247521,3160,5554,8714,Fall,Clear,107,5554,8714,4,4,4,444
625,2012-09-16,3,1,9,0,0,0,1,0.58,0.563125,0.57,0.0901833,2166,5167,7333,Fall,Clear,106,5167,7333,4,4,4,444
626,2012-09-17,3,1,9,0,1,1,2,0.580833,0.55305,0.734583,0.151742,1022,5847,6869,Fall,Mist + Cloudy,105,5847,6869,4,4,4,444
627,2012-09-18,3,1,9,0,2,1,2,0.623333,0.565067,0.8725,0.357587,371,3702,4073,Fall,Mist + Cloudy,104,3702,4073,4,3,2,432
628,2012-09-19,3,1,9,0,3,1,1,0.5525,0.540404,0.536667,0.215175,788,6803,7591,Fall,Clear,103,6803,7591,4,4,4,444
629,2012-09-20,3,1,9,0,4,1,1,0.546667,0.532192,0.618333,0.118167,939,6781,7720,Fall,Clear,102,6781,7720,4,4,4,444
630,2012-09-21,3,1,9,0,5,1,1,0.599167,0.571971,0.66875,0.154229,1250,6917,8167,Fall,Clear,101,6917,8167,4,4,4,444
631,2012-09-22,3,1,9,0,6,0,1,0.65,0.610488,0.646667,0.283583,2512,5883,8395,Fall,Clear,100,5883,8395,4,4,4,444
632,2012-09-23,4,1,9,0,0,0,1,0.529167,0.518933,0.467083,0.223258,2454,5453,7907,Winter,Clear,99,5453,7907,4,4,4,444
633,2012-09-24,4,1,9,0,1,1,1,0.514167,0.502513,0.492917,0.142404,1001,6435,7436,Winter,Clear,98,6435,7436,4,4,4,444
634,2012-09-25,4,1,9,0,2,1,1,0.55,0.544179,0.57,0.236321,845,6693,7538,Winter,Clear,97,6693,7538,4,4,4,444
635,2012-09-26,4,1,9,0,3,1,1,0.635,0.596613,0.630833,0.2444,787,6946,7733,Winter,Clear,96,6946,7733,4,4,4,444
636,2012-09-27,4,1,9,0,4,1,2,0.65,0.607975,0.690833,0.134342,751,6642,7393,Winter,Mist + Cloudy,95,6642,7393,4,4,4,444
637,2012-09-28,4,1,9,0,5,1,2,0.619167,0.585863,0.69,0.164179,1045,6370,7415,Winter,Mist + Cloudy,94,6370,7415,4,4,4,444
638,2012-09-29,4,1,9,0,6,0,1,0.5425,0.530296,0.542917,0.227604,2589,5966,8555,Winter,Clear,93,5966,8555,4,4,4,444
639,2012-09-30,4,1,9,0,0,0,1,0.526667,0.517663,0.583333,0.134958,2015,4874,6889,Winter,Clear,92,4874,6889,4,4,4,444
640,2012-10-01,4,1,10,0,1,1,2,0.520833,0.512,0.649167,0.0908042,763,6015,6778,Winter,Mist + Cloudy,91,6015,6778,4,4,4,444
641,2012-10-02,4,1,10,0,2,1,3,0.590833,0.542333,0.871667,0.104475,315,4324,4639,Winter,Light Snow/Rain,90,4324,4639,4,3,3,433
642,2012-10-03,4,1,10,0,3,1,2,0.6575,0.599133,0.79375,0.0665458,728,6844,7572,Winter,Mist + Cloudy,89,6844,7572,4,4,4,444
643,2012-10-04,4,1,10,0,4,1,2,0.6575,0.607975,0.722917,0.117546,891,6437,7328,Winter,Mist + Cloudy,88,6437,7328,4,4,4,444
644,2012-10-05,4,1,10,0,5,1,1,0.615,0.580187,0.6275,0.10635,1516,6640,8156,Winter,Clear,87,6640,8156,4,4,4,444
645,2012-10-06,4,1,10,0,6,0,1,0.554167,0.538521,0.664167,0.268025,3031,4934,7965,Winter,Clear,86,4934,7965,4,4,4,444
646,2012-10-07,4,1,10,0,0,0,2,0.415833,0.419813,0.708333,0.141162,781,2729,3510,Winter,Mist + Cloudy,85,2729,3510,4,2,2,422
647,2012-10-08,4,1,10,1,1,0,2,0.383333,0.387608,0.709583,0.189679,874,4604,5478,Winter,Mist + Cloudy,84,4604,5478,4,3,3,433
648,2012-10-09,4,1,10,0,2,1,2,0.446667,0.438112,0.761667,0.1903,601,5791,6392,Winter,Mist + Cloudy,83,5791,6392,4,4,4,444
649,2012-10-10,4,1,10,0,3,1,1,0.514167,0.503142,0.630833,0.187821,780,6911,7691,Winter,Clear,82,6911,7691,4,4,4,444
650,2012-10-11,4,1,10,0,4,1,1,0.435,0.431167,0.463333,0.181596,834,6736,7570,Winter,Clear,81,6736,7570,4,4,4,444
651,2012-10-12,4,1,10,0,5,1,1,0.4375,0.433071,0.539167,0.235092,1060,6222,7282,Winter,Clear,80,6222,7282,4,4,4,444
652,2012-10-13,4,1,10,0,6,0,1,0.393333,0.391396,0.494583,0.146142,2252,4857,7109,Winter,Clear,79,4857,7109,4,4,4,444
653,2012-10-14,4,1,10,0,0,0,1,0.521667,0.508204,0.640417,0.278612,2080,4559,6639,Winter,Clear,78,4559,6639,4,3,4,434
654,2012-10-15,4,1,10,0,1,1,2,0.561667,0.53915,0.7075,0.296037,760,5115,5875,Winter,Mist + Cloudy,77,5115,5875,4,4,3,443
655,2012-10-16,4,1,10,0,2,1,1,0.468333,0.460846,0.558333,0.182221,922,6612,7534,Winter,Clear,76,6612,7534,4,4,4,444
656,2012-10-17,4,1,10,0,3,1,1,0.455833,0.450108,0.692917,0.101371,979,6482,7461,Winter,Clear,75,6482,7461,4,4,4,444
657,2012-10-18,4,1,10,0,4,1,2,0.5225,0.512625,0.728333,0.236937,1008,6501,7509,Winter,Mist + Cloudy,74,6501,7509,4,4,4,444
658,2012-10-19,4,1,10,0,5,1,2,0.563333,0.537896,0.815,0.134954,753,4671,5424,Winter,Mist + Cloudy,73,4671,5424,4,3,3,433
659,2012-10-20,4,1,10,0,6,0,1,0.484167,0.472842,0.572917,0.117537,2806,5284,8090,Winter,Clear,72,5284,8090,4,4,4,444
660,2012-10-21,4,1,10,0,0,0,1,0.464167,0.456429,0.51,0.166054,2132,4692,6824,Winter,Clear,71,4692,6824,4,3,4,434
661,2012-10-22,4,1,10,0,1,1,1,0.4875,0.482942,0.568333,0.0814833,830,6228,7058,Winter,Clear,70,6228,7058,4,4,4,444
662,2012-10-23,4,1,10,0,2,1,1,0.544167,0.530304,0.641667,0.0945458,841,6625,7466,Winter,Clear,69,6625,7466,4,4,4,444
663,2012-10-24,4,1,10,0,3,1,1,0.5875,0.558721,0.63625,0.0727792,795,6898,7693,Winter,Clear,68,6898,7693,4,4,4,444
664,2012-10-25,4,1,10,0,4,1,2,0.55,0.529688,0.800417,0.124375,875,6484,7359,Winter,Mist + Cloudy,67,6484,7359,4,4,4,444
665,2012-10-26,4,1,10,0,5,1,2,0.545833,0.52275,0.807083,0.132467,1182,6262,7444,Winter,Mist + Cloudy,66,6262,7444,4,4,4,444
666,2012-10-27,4,1,10,0,6,0,2,0.53,0.515133,0.72,0.235692,2643,5209,7852,Winter,Mist + Cloudy,65,5209,7852,4,4,4,444
667,2012-10-28,4,1,10,0,0,0,2,0.4775,0.467771,0.694583,0.398008,998,3461,4459,Winter,Mist + Cloudy,64,3461,4459,4,2,2,422
668,2012-10-29,4,1,10,0,1,1,3,0.44,0.4394,0.88,0.3582,2,20,22,Winter,Light Snow/Rain,63,20,22,4,1,1,411
669,2012-10-30,4,1,10,0,2,1,2,0.318182,0.309909,0.825455,0.213009,87,1009,1096,Winter,Mist + Cloudy,62,1009,1096,4,1,1,411
670,2012-10-31,4,1,10,0,3,1,2,0.3575,0.3611,0.666667,0.166667,419,5147,5566,Winter,Mist + Cloudy,61,5147,5566,4,4,3,443
671,2012-11-01,4,1,11,0,4,1,2,0.365833,0.369942,0.581667,0.157346,466,5520,5986,Winter,Mist + Cloudy,60,5520,5986,4,4,4,444
672,2012-11-02,4,1,11,0,5,1,1,0.355,0.356042,0.522083,0.266175,618,5229,5847,Winter,Clear,59,5229,5847,4,4,3,443
673,2012-11-03,4,1,11,0,6,0,2,0.343333,0.323846,0.49125,0.270529,1029,4109,5138,Winter,Mist + Cloudy,58,4109,5138,4,3,3,433
674,2012-11-04,4,1,11,0,0,0,1,0.325833,0.329538,0.532917,0.179108,1201,3906,5107,Winter,Clear,57,3906,5107,4,3,3,433
675,2012-11-05,4,1,11,0,1,1,1,0.319167,0.308075,0.494167,0.236325,378,4881,5259,Winter,Clear,56,4881,5259,4,4,3,443
676,2012-11-06,4,1,11,0,2,1,1,0.280833,0.281567,0.567083,0.173513,466,5220,5686,Winter,Clear,55,5220,5686,4,4,3,443
677,2012-11-07,4,1,11,0,3,1,2,0.295833,0.274621,0.5475,0.304108,326,4709,5035,Winter,Mist + Cloudy,54,4709,5035,4,3,3,433
678,2012-11-08,4,1,11,0,4,1,1,0.352174,0.341891,0.333478,0.347835,340,4975,5315,Winter,Clear,53,4975,5315,4,4,3,443
679,2012-11-09,4,1,11,0,5,1,1,0.361667,0.355413,0.540833,0.214558,709,5283,5992,Winter,Clear,52,5283,5992,4,4,4,444
680,2012-11-10,4,1,11,0,6,0,1,0.389167,0.393937,0.645417,0.0578458,2090,4446,6536,Winter,Clear,51,4446,6536,4,3,4,434
681,2012-11-11,4,1,11,0,0,0,1,0.420833,0.421713,0.659167,0.1275,2290,4562,6852,Winter,Clear,50,4562,6852,4,3,4,434
682,2012-11-12,4,1,11,1,1,0,1,0.485,0.475383,0.741667,0.173517,1097,5172,6269,Winter,Clear,49,5172,6269,4,4,4,444
683,2012-11-13,4,1,11,0,2,1,2,0.343333,0.323225,0.662917,0.342046,327,3767,4094,Winter,Mist + Cloudy,48,3767,4094,4,3,2,432
684,2012-11-14,4,1,11,0,3,1,1,0.289167,0.281563,0.552083,0.199625,373,5122,5495,Winter,Clear,47,5122,5495,4,4,3,443
685,2012-11-15,4,1,11,0,4,1,2,0.321667,0.324492,0.620417,0.152987,320,5125,5445,Winter,Mist + Cloudy,46,5125,5445,4,4,3,443
686,2012-11-16,4,1,11,0,5,1,1,0.345,0.347204,0.524583,0.171025,484,5214,5698,Winter,Clear,45,5214,5698,4,4,3,443
687,2012-11-17,4,1,11,0,6,0,1,0.325,0.326383,0.545417,0.179729,1313,4316,5629,Winter,Clear,44,4316,5629,4,3,3,433
688,2012-11-18,4,1,11,0,0,0,1,0.3425,0.337746,0.692917,0.227612,922,3747,4669,Winter,Clear,43,3747,4669,4,3,3,433
689,2012-11-19,4,1,11,0,1,1,2,0.380833,0.375621,0.623333,0.235067,449,5050,5499,Winter,Mist + Cloudy,42,5050,5499,4,4,3,443
690,2012-11-20,4,1,11,0,2,1,2,0.374167,0.380667,0.685,0.082725,534,5100,5634,Winter,Mist + Cloudy,41,5100,5634,4,4,3,443
691,2012-11-21,4,1,11,0,3,1,1,0.353333,0.364892,0.61375,0.103246,615,4531,5146,Winter,Clear,40,4531,5146,4,3,3,433
692,2012-11-22,4,1,11,1,4,0,1,0.34,0.350371,0.580417,0.0528708,955,1470,2425,Winter,Clear,39,1470,2425,4,1,1,411
693,2012-11-23,4,1,11,0,5,1,1,0.368333,0.378779,0.56875,0.148021,1603,2307,3910,Winter,Clear,38,2307,3910,4,1,2,412
694,2012-11-24,4,1,11,0,6,0,1,0.278333,0.248742,0.404583,0.376871,532,1745,2277,Winter,Clear,37,1745,2277,4,1,1,411
695,2012-11-25,4,1,11,0,0,0,1,0.245833,0.257583,0.468333,0.1505,309,2115,2424,Winter,Clear,36,2115,2424,4,1,1,411
696,2012-11-26,4,1,11,0,1,1,1,0.313333,0.339004,0.535417,0.04665,337,4750,5087,Winter,Clear,35,4750,5087,4,3,3,433
697,2012-11-27,4,1,11,0,2,1,2,0.291667,0.281558,0.786667,0.237562,123,3836,3959,Winter,Mist + Cloudy,34,3836,3959,4,3,2,432
698,2012-11-28,4,1,11,0,3,1,1,0.296667,0.289762,0.50625,0.210821,198,5062,5260,Winter,Clear,33,5062,5260,4,4,3,443
699,2012-11-29,4,1,11,0,4,1,1,0.28087,0.298422,0.555652,0.115522,243,5080,5323,Winter,Clear,32,5080,5323,4,4,3,443
700,2012-11-30,4,1,11,0,5,1,1,0.298333,0.323867,0.649583,0.0584708,362,5306,5668,Winter,Clear,31,5306,5668,4,4,3,443
701,2012-12-01,4,1,12,0,6,0,2,0.298333,0.316904,0.806667,0.0597042,951,4240,5191,Winter,Mist + Cloudy,30,4240,5191,4,3,3,433
702,2012-12-02,4,1,12,0,0,0,2,0.3475,0.359208,0.823333,0.124379,892,3757,4649,Winter,Mist + Cloudy,29,3757,4649,4,3,3,433
703,2012-12-03,4,1,12,0,1,1,1,0.4525,0.455796,0.7675,0.0827208,555,5679,6234,Winter,Clear,28,5679,6234,4,4,4,444
704,2012-12-04,4,1,12,0,2,1,1,0.475833,0.469054,0.73375,0.174129,551,6055,6606,Winter,Clear,27,6055,6606,4,4,4,444
705,2012-12-05,4,1,12,0,3,1,1,0.438333,0.428012,0.485,0.324021,331,5398,5729,Winter,Clear,26,5398,5729,4,4,3,443
706,2012-12-06,4,1,12,0,4,1,1,0.255833,0.258204,0.50875,0.174754,340,5035,5375,Winter,Clear,25,5035,5375,4,4,3,443
707,2012-12-07,4,1,12,0,5,1,2,0.320833,0.321958,0.764167,0.1306,349,4659,5008,Winter,Mist + Cloudy,24,4659,5008,4,3,3,433
708,2012-12-08,4,1,12,0,6,0,2,0.381667,0.389508,0.91125,0.101379,1153,4429,5582,Winter,Mist + Cloudy,23,4429,5582,4,3,3,433
709,2012-12-09,4,1,12,0,0,0,2,0.384167,0.390146,0.905417,0.157975,441,2787,3228,Winter,Mist + Cloudy,22,2787,3228,4,2,2,422
710,2012-12-10,4,1,12,0,1,1,2,0.435833,0.435575,0.925,0.190308,329,4841,5170,Winter,Mist + Cloudy,21,4841,5170,4,4,3,443
711,2012-12-11,4,1,12,0,2,1,2,0.353333,0.338363,0.596667,0.296037,282,5219,5501,Winter,Mist + Cloudy,20,5219,5501,4,4,3,443
712,2012-12-12,4,1,12,0,3,1,2,0.2975,0.297338,0.538333,0.162937,310,5009,5319,Winter,Mist + Cloudy,19,5009,5319,4,4,3,443
713,2012-12-13,4,1,12,0,4,1,1,0.295833,0.294188,0.485833,0.174129,425,5107,5532,Winter,Clear,18,5107,5532,4,4,3,443
714,2012-12-14,4,1,12,0,5,1,1,0.281667,0.294192,0.642917,0.131229,429,5182,5611,Winter,Clear,17,5182,5611,4,4,3,443
715,2012-12-15,4,1,12,0,6,0,1,0.324167,0.338383,0.650417,0.10635,767,4280,5047,Winter,Clear,16,4280,5047,4,3,3,433
716,2012-12-16,4,1,12,0,0,0,2,0.3625,0.369938,0.83875,0.100742,538,3248,3786,Winter,Mist + Cloudy,15,3248,3786,4,2,2,422
717,2012-12-17,4,1,12,0,1,1,2,0.393333,0.4015,0.907083,0.0982583,212,4373,4585,Winter,Mist + Cloudy,14,4373,4585,4,3,3,433
718,2012-12-18,4,1,12,0,2,1,1,0.410833,0.409708,0.66625,0.221404,433,5124,5557,Winter,Clear,13,5124,5557,4,4,3,443
719,2012-12-19,4,1,12,0,3,1,1,0.3325,0.342162,0.625417,0.184092,333,4934,5267,Winter,Clear,12,4934,5267,4,4,3,443
720,2012-12-20,4,1,12,0,4,1,2,0.33,0.335217,0.667917,0.132463,314,3814,4128,Winter,Mist + Cloudy,11,3814,4128,4,3,2,432
721,2012-12-21,1,1,12,0,5,1,2,0.326667,0.301767,0.556667,0.374383,221,3402,3623,Spring,Mist + Cloudy,10,3402,3623,4,2,2,422
722,2012-12-22,1,1,12,0,6,0,1,0.265833,0.236113,0.44125,0.407346,205,1544,1749,Spring,Clear,9,1544,1749,4,1,1,411
723,2012-12-23,1,1,12,0,0,0,1,0.245833,0.259471,0.515417,0.133083,408,1379,1787,Spring,Clear,8,1379,1787,4,1,1,411
724,2012-12-24,1,1,12,0,1,1,2,0.231304,0.2589,0.791304,0.0772304,174,746,920,Spring,Mist + Cloudy,7,746,920,4,1,1,411
725,2012-12-25,1,1,12,1,2,0,2,0.291304,0.294465,0.734783,0.168726,440,573,1013,Spring,Mist + Cloudy,6,573,1013,4,1,1,411
726,2012-12-26,1,1,12,0,3,1,3,0.243333,0.220333,0.823333,0.316546,9,432,441,Spring,Light Snow/Rain,5,432,441,4,1,1,411
727,2012-12-27,1,1,12,0,4,1,2,0.254167,0.226642,0.652917,0.350133,247,1867,2114,Spring,Mist + Cloudy,4,1867,2114,4,1,1,411
728,2012-12-28,1,1,12,0,5,1,2,0.253333,0.255046,0.59,0.155471,644,2451,3095,Spring,Mist + Cloudy,3,2451,3095,4,1,1,411
729,2012-12-29,1,1,12,0,6,0,2,0.253333,0.2424,0.752917,0.124383,159,1182,1341,Spring,Mist + Cloudy,2,1182,1341,4,1,1,411
730,2012-12-30,1,1,12,0,0,0,1,0.255833,0.2317,0.483333,0.350754,364,1432,1796,Spring,Clear,1,1432,1796,4,1,1,411
731,2012-12-31,1,1,12,0,1,1,2,0.215833,0.223487,0.5775,0.154846,439,2290,2729,Spring,Mist + Cloudy,0,2290,2729,4,1,1,411
